a|a
b|b
c|c
d|d
e|e
f|f
g|g
h|h
i|i
j|j
k|k
l|l
m|m
n|n
o|o
p|p
q|q
r|r
s|s
t|t
ba|ba
bb|bb
bc|bc
bd|bd
be|be
bf|bf
bg|bg
bh|bh
bi|bi
bj|bj
bk|bk
bl|bl
bm|bm
bn|bn
bo|bo
bp|bp
bq|bq
br|br
bs|bs
bt|bt
ca|ca
cb|cb
cc|cc
cd|cd
ce|ce
cf|cf
cg|cg
ch|ch
ci|ci
cj|cj
ck|ck
cl|cl
cm|cm
cn|cn
co|co
cp|cp
cq|cq
cr|cr
cs|cs
ct|ct
da|da
db|db
dc|dc
dd|dd
de|de
df|df
dg|dg
dh|dh
di|di
dj|dj
dk|dk
dl|dl
dm|dm
dn|dn
do|do
dp|dp
dq|dq
dr|dr
ds|ds
dt|dt
ea|ea
eb|eb
ec|ec
ed|ed
ee|ee
ef|ef
eg|eg
eh|eh
ei|ei
ej|ej
ek|ek
el|el
em|em
en|en
eo|eo
ep|ep
eq|eq
er|er
es|es
et|et
fa|fa
fb|fb
fc|fc
fd|fd
fe|fe
ff|ff
fg|fg
fh|fh
fi|fi
fj|fj
fk|fk
fl|fl
fm|fm
fn|fn
fo|fo
fp|fp
fq|fq
fr|fr
fs|fs
ft|ft
ga|ga
gb|gb
gc|gc
gd|gd
ge|ge
gf|gf
gg|gg
gh|gh
gi|gi
gj|gj
gk|gk
gl|gl
gm|gm
gn|gn
go|go
gp|gp
gq|gq
gr|gr
gs|gs
gt|gt
ha|ha
hb|hb
hc|hc
hd|hd
he|he
hf|hf
hg|hg
hh|hh
hi|hi
hj|hj
hk|hk
hl|hl
hm|hm
hn|hn
ho|ho
hp|hp
hq|hq
hr|hr
hs|hs
ht|ht
ia|ia
ib|ib
ic|ic
id|id
ie|ie
if|if
ig|ig
ih|ih
ii|ii
ij|ij
ik|ik
il|il
im|im
in|in
io|io
ip|ip
iq|iq
ir|ir
is|is
it|it
ja|ja
jb|jb
jc|jc
jd|jd
je|je
jf|jf
jg|jg
jh|jh
ji|ji
jj|jj
jk|jk
jl|jl
jm|jm
jn|jn
jo|jo
jp|jp
jq|jq
jr|jr
js|js
jt|jt
ka|ka
kb|kb
kc|kc
kd|kd
ke|ke
kf|kf
kg|kg
kh|kh
ki|ki
kj|kj
kk|kk
kl|kl
km|km
kn|kn
ko|ko
kp|kp
kq|kq
kr|kr
ks|ks
kt|kt
la|la
lb|lb
lc|lc
ld|ld
le|le
lf|lf
lg|lg
lh|lh
li|li
lj|lj
lk|lk
ll|ll
lm|lm
ln|ln
lo|lo
lp|lp
lq|lq
lr|lr
ls|ls
lt|lt
ma|ma
mb|mb
mc|mc
md|md
me|me
mf|mf
mg|mg
mh|mh
mi|mi
mj|mj
mk|mk
ml|ml
mm|mm
mn|mn
mo|mo
mp|mp
mq|mq
mr|mr
ms|ms
mt|mt
na|na
nb|nb
nc|nc
nd|nd
ne|ne
nf|nf
ng|ng
nh|nh
ni|ni
nj|nj
nk|nk
nl|nl
nm|nm
nn|nn
no|no
np|np
nq|nq
nr|nr
ns|ns
nt|nt
oa|oa
ob|ob
oc|oc
od|od
oe|oe
of|of
og|og
oh|oh
oi|oi
oj|oj
ok|ok
ol|ol
om|om
on|on
oo|oo
op|op
oq|oq
or|or
os|os
ot|ot
pa|pa
pb|pb
pc|pc
pd|pd
pe|pe
pf|pf
pg|pg
ph|ph
pi|pi
pj|pj
pk|pk
pl|pl
pm|pm
pn|pn
po|po
pp|pp
pq|pq
pr|pr
ps|ps
pt|pt
qa|qa
qb|qb
qc|qc
qd|qd
qe|qe
qf|qf
qg|qg
qh|qh
qi|qi
qj|qj
qk|qk
ql|ql
qm|qm
qn|qn
qo|qo
qp|qp
qq|qq
qr|qr
qs|qs
qt|qt
ra|ra
rb|rb
rc|rc
rd|rd
re|re
rf|rf
rg|rg
rh|rh
ri|ri
rj|rj
rk|rk
rl|rl
rm|rm
rn|rn
ro|ro
rp|rp
rq|rq
rr|rr
rs|rs
rt|rt
sa|sa
sb|sb
sc|sc
sd|sd
se|se
sf|sf
sg|sg
sh|sh
si|si
sj|sj
sk|sk
sl|sl
sm|sm
sn|sn
so|so
sp|sp
sq|sq
sr|sr
ss|ss
st|st
ta|ta
tb|tb
tc|tc
td|td
te|te
tf|tf
tg|tg
th|th
ti|ti
tj|tj
tk|tk
tl|tl
tm|tm
tn|tn
to|to
tp|tp
tq|tq
tr|tr
ts|ts
tt|tt
baa|baa
bab|bab
bac|bac
bad|bad
bae|bae
baf|baf
bag|bag
bah|bah
bai|bai
baj|baj
bak|bak
bal|bal
bam|bam
ban|ban
bao|bao
bap|bap
baq|baq
bar|bar
bas|bas
bat|bat
bba|bba
bbb|bbb
bbc|bbc
bbd|bbd
bbe|bbe
bbf|bbf
bbg|bbg
bbh|bbh
bbi|bbi
bbj|bbj
bbk|bbk
bbl|bbl
bbm|bbm
bbn|bbn
bbo|bbo
bbp|bbp
bbq|bbq
bbr|bbr
bbs|bbs
bbt|bbt
bca|bca
bcb|bcb
bcc|bcc
bcd|bcd
bce|bce
bcf|bcf
bcg|bcg
bch|bch
bci|bci
bcj|bcj
bck|bck
bcl|bcl
bcm|bcm
bcn|bcn
bco|bco
bcp|bcp
bcq|bcq
bcr|bcr
bcs|bcs
bct|bct
bda|bda
bdb|bdb
bdc|bdc
bdd|bdd
bde|bde
bdf|bdf
bdg|bdg
bdh|bdh
bdi|bdi
bdj|bdj
bdk|bdk
bdl|bdl
bdm|bdm
bdn|bdn
bdo|bdo
bdp|bdp
bdq|bdq
bdr|bdr
bds|bds
bdt|bdt
bea|bea
beb|beb
bec|bec
bed|bed
bee|bee
bef|bef
beg|beg
beh|beh
bei|bei
bej|bej
bek|bek
bel|bel
bem|bem
ben|ben
beo|beo
bep|bep
beq|beq
ber|ber
bes|bes
bet|bet
bfa|bfa
bfb|bfb
bfc|bfc
bfd|bfd
bfe|bfe
bff|bff
bfg|bfg
bfh|bfh
bfi|bfi
bfj|bfj
bfk|bfk
bfl|bfl
bfm|bfm
bfn|bfn
bfo|bfo
bfp|bfp
bfq|bfq
bfr|bfr
bfs|bfs
bft|bft
bga|bga
bgb|bgb
bgc|bgc
bgd|bgd
bge|bge
bgf|bgf
bgg|bgg
bgh|bgh
bgi|bgi
bgj|bgj
bgk|bgk
bgl|bgl
bgm|bgm
bgn|bgn
bgo|bgo
bgp|bgp
bgq|bgq
bgr|bgr
bgs|bgs
bgt|bgt
bha|bha
bhb|bhb
bhc|bhc
bhd|bhd
bhe|bhe
bhf|bhf
bhg|bhg
bhh|bhh
bhi|bhi
bhj|bhj
bhk|bhk
bhl|bhl
bhm|bhm
bhn|bhn
bho|bho
bhp|bhp
bhq|bhq
bhr|bhr
bhs|bhs
bht|bht
bia|bia
bib|bib
bic|bic
bid|bid
bie|bie
bif|bif
big|big
bih|bih
bii|bii
bij|bij
bik|bik
bil|bil
bim|bim
bin|bin
bio|bio
bip|bip
biq|biq
bir|bir
bis|bis
bit|bit
bja|bja
bjb|bjb
bjc|bjc
bjd|bjd
bje|bje
bjf|bjf
bjg|bjg
bjh|bjh
bji|bji
bjj|bjj
bjk|bjk
bjl|bjl
bjm|bjm
bjn|bjn
bjo|bjo
bjp|bjp
bjq|bjq
bjr|bjr
bjs|bjs
bjt|bjt
bka|bka
bkb|bkb
bkc|bkc
bkd|bkd
bke|bke
bkf|bkf
bkg|bkg
bkh|bkh
bki|bki
bkj|bkj
bkk|bkk
bkl|bkl
bkm|bkm
bkn|bkn
bko|bko
bkp|bkp
bkq|bkq
bkr|bkr
bks|bks
bkt|bkt
bla|bla
blb|blb
blc|blc
bld|bld
ble|ble
blf|blf
blg|blg
blh|blh
bli|bli
blj|blj
blk|blk
bll|bll
blm|blm
bln|bln
blo|blo
blp|blp
blq|blq
blr|blr
bls|bls
blt|blt
bma|bma
bmb|bmb
bmc|bmc
bmd|bmd
bme|bme
bmf|bmf
bmg|bmg
bmh|bmh
bmi|bmi
bmj|bmj
bmk|bmk
bml|bml
bmm|bmm
bmn|bmn
bmo|bmo
bmp|bmp
bmq|bmq
bmr|bmr
bms|bms
bmt|bmt
bna|bna
bnb|bnb
bnc|bnc
bnd|bnd
bne|bne
bnf|bnf
bng|bng
bnh|bnh
bni|bni
bnj|bnj
bnk|bnk
bnl|bnl
bnm|bnm
bnn|bnn
bno|bno
bnp|bnp
bnq|bnq
bnr|bnr
bns|bns
bnt|bnt
boa|boa
bob|bob
boc|boc
bod|bod
boe|boe
bof|bof
bog|bog
boh|boh
boi|boi
boj|boj
bok|bok
bol|bol
bom|bom
bon|bon
boo|boo
bop|bop
boq|boq
bor|bor
bos|bos
bot|bot
bpa|bpa
bpb|bpb
bpc|bpc
bpd|bpd
bpe|bpe
bpf|bpf
bpg|bpg
bph|bph
bpi|bpi
bpj|bpj
bpk|bpk
bpl|bpl
bpm|bpm
bpn|bpn
bpo|bpo
bpp|bpp
bpq|bpq
bpr|bpr
bps|bps
bpt|bpt
bqa|bqa
bqb|bqb
bqc|bqc
bqd|bqd
bqe|bqe
bqf|bqf
bqg|bqg
bqh|bqh
bqi|bqi
bqj|bqj
bqk|bqk
bql|bql
bqm|bqm
bqn|bqn
bqo|bqo
bqp|bqp
bqq|bqq
bqr|bqr
bqs|bqs
bqt|bqt
bra|bra
brb|brb
brc|brc
brd|brd
bre|bre
brf|brf
brg|brg
brh|brh
bri|bri
brj|brj
brk|brk
brl|brl
brm|brm
brn|brn
bro|bro
brp|brp
brq|brq
brr|brr
brs|brs
brt|brt
bsa|bsa
bsb|bsb
bsc|bsc
bsd|bsd
bse|bse
bsf|bsf
bsg|bsg
bsh|bsh
bsi|bsi
bsj|bsj
bsk|bsk
bsl|bsl
bsm|bsm
bsn|bsn
bso|bso
bsp|bsp
bsq|bsq
bsr|bsr
bss|bss
bst|bst
bta|bta
btb|btb
btc|btc
btd|btd
bte|bte
btf|btf
btg|btg
bth|bth
bti|bti
btj|btj
btk|btk
btl|btl
btm|btm
btn|btn
bto|bto
btp|btp
btq|btq
btr|btr
bts|bts
btt|btt
caa|caa
cab|cab
cac|cac
cad|cad
cae|cae
caf|caf
cag|cag
cah|cah
cai|cai
caj|caj
cak|cak
cal|cal
cam|cam
can|can
cao|cao
cap|cap
caq|caq
car|car
cas|cas
cat|cat
cba|cba
cbb|cbb
cbc|cbc
cbd|cbd
cbe|cbe
cbf|cbf
cbg|cbg
cbh|cbh
cbi|cbi
cbj|cbj
cbk|cbk
cbl|cbl
cbm|cbm
cbn|cbn
cbo|cbo
cbp|cbp
cbq|cbq
cbr|cbr
cbs|cbs
cbt|cbt
cca|cca
ccb|ccb
ccc|ccc
ccd|ccd
cce|cce
ccf|ccf
ccg|ccg
cch|cch
cci|cci
ccj|ccj
cck|cck
ccl|ccl
ccm|ccm
ccn|ccn
cco|cco
ccp|ccp
ccq|ccq
ccr|ccr
ccs|ccs
cct|cct
cda|cda
cdb|cdb
cdc|cdc
cdd|cdd
cde|cde
cdf|cdf
cdg|cdg
cdh|cdh
cdi|cdi
cdj|cdj
cdk|cdk
cdl|cdl
cdm|cdm
cdn|cdn
cdo|cdo
cdp|cdp
cdq|cdq
cdr|cdr
cds|cds
cdt|cdt
cea|cea
ceb|ceb
cec|cec
ced|ced
cee|cee
cef|cef
ceg|ceg
ceh|ceh
cei|cei
cej|cej
cek|cek
cel|cel
cem|cem
cen|cen
ceo|ceo
cep|cep
ceq|ceq
cer|cer
ces|ces
cet|cet
cfa|cfa
cfb|cfb
cfc|cfc
cfd|cfd
cfe|cfe
cff|cff
cfg|cfg
cfh|cfh
cfi|cfi
cfj|cfj
cfk|cfk
cfl|cfl
cfm|cfm
cfn|cfn
cfo|cfo
cfp|cfp
cfq|cfq
cfr|cfr
cfs|cfs
cft|cft
cga|cga
cgb|cgb
cgc|cgc
cgd|cgd
cge|cge
cgf|cgf
cgg|cgg
cgh|cgh
cgi|cgi
cgj|cgj
cgk|cgk
cgl|cgl
cgm|cgm
cgn|cgn
cgo|cgo
cgp|cgp
cgq|cgq
cgr|cgr
cgs|cgs
cgt|cgt
cha|cha
chb|chb
chc|chc
chd|chd
che|che
chf|chf
chg|chg
chh|chh
chi|chi
chj|chj
chk|chk
chl|chl
chm|chm
chn|chn
cho|cho
chp|chp
chq|chq
chr|chr
chs|chs
cht|cht
cia|cia
cib|cib
cic|cic
cid|cid
cie|cie
cif|cif
cig|cig
cih|cih
cii|cii
cij|cij
cik|cik
cil|cil
cim|cim
cin|cin
cio|cio
cip|cip
ciq|ciq
cir|cir
cis|cis
cit|cit
cja|cja
cjb|cjb
cjc|cjc
cjd|cjd
cje|cje
cjf|cjf
cjg|cjg
cjh|cjh
cji|cji
cjj|cjj
cjk|cjk
cjl|cjl
cjm|cjm
cjn|cjn
cjo|cjo
cjp|cjp
cjq|cjq
cjr|cjr
cjs|cjs
cjt|cjt
cka|cka
ckb|ckb
ckc|ckc
ckd|ckd
cke|cke
ckf|ckf
ckg|ckg
ckh|ckh
cki|cki
ckj|ckj
ckk|ckk
ckl|ckl
ckm|ckm
ckn|ckn
cko|cko
ckp|ckp
ckq|ckq
ckr|ckr
cks|cks
ckt|ckt
cla|cla
clb|clb
clc|clc
cld|cld
cle|cle
clf|clf
clg|clg
clh|clh
cli|cli
clj|clj
clk|clk
cll|cll
clm|clm
cln|cln
clo|clo
clp|clp
clq|clq
clr|clr
cls|cls
clt|clt
cma|cma
cmb|cmb
cmc|cmc
cmd|cmd
cme|cme
cmf|cmf
cmg|cmg
cmh|cmh
cmi|cmi
cmj|cmj
cmk|cmk
cml|cml
cmm|cmm
cmn|cmn
cmo|cmo
cmp|cmp
cmq|cmq
cmr|cmr
cms|cms
cmt|cmt
cna|cna
cnb|cnb
cnc|cnc
cnd|cnd
cne|cne
cnf|cnf
cng|cng
cnh|cnh
cni|cni
cnj|cnj
cnk|cnk
cnl|cnl
cnm|cnm
cnn|cnn
cno|cno
cnp|cnp
cnq|cnq
cnr|cnr
cns|cns
cnt|cnt
coa|coa
cob|cob
coc|coc
cod|cod
coe|coe
cof|cof
cog|cog
coh|coh
coi|coi
coj|coj
cok|cok
col|col
com|com
con|con
coo|coo
cop|cop
coq|coq
cor|cor
cos|cos
cot|cot
cpa|cpa
cpb|cpb
cpc|cpc
cpd|cpd
cpe|cpe
cpf|cpf
cpg|cpg
cph|cph
cpi|cpi
cpj|cpj
cpk|cpk
cpl|cpl
cpm|cpm
cpn|cpn
cpo|cpo
cpp|cpp
cpq|cpq
cpr|cpr
cps|cps
cpt|cpt
cqa|cqa
cqb|cqb
cqc|cqc
cqd|cqd
cqe|cqe
cqf|cqf
cqg|cqg
cqh|cqh
cqi|cqi
cqj|cqj
cqk|cqk
cql|cql
cqm|cqm
cqn|cqn
cqo|cqo
cqp|cqp
cqq|cqq
cqr|cqr
cqs|cqs
cqt|cqt
cra|cra
crb|crb
crc|crc
crd|crd
cre|cre
crf|crf
crg|crg
crh|crh
cri|cri
crj|crj
crk|crk
crl|crl
crm|crm
crn|crn
cro|cro
crp|crp
crq|crq
crr|crr
crs|crs
crt|crt
csa|csa
csb|csb
csc|csc
csd|csd
cse|cse
csf|csf
csg|csg
csh|csh
csi|csi
csj|csj
csk|csk
csl|csl
csm|csm
csn|csn
cso|cso
csp|csp
csq|csq
csr|csr
css|css
cst|cst
cta|cta
ctb|ctb
ctc|ctc
ctd|ctd
cte|cte
ctf|ctf
ctg|ctg
cth|cth
cti|cti
ctj|ctj
ctk|ctk
ctl|ctl
ctm|ctm
ctn|ctn
cto|cto
ctp|ctp
ctq|ctq
ctr|ctr
cts|cts
ctt|ctt
daa|daa
dab|dab
dac|dac
dad|dad
dae|dae
daf|daf
dag|dag
dah|dah
dai|dai
daj|daj
dak|dak
dal|dal
dam|dam
dan|dan
dao|dao
dap|dap
daq|daq
dar|dar
das|das
dat|dat
dba|dba
dbb|dbb
dbc|dbc
dbd|dbd
dbe|dbe
dbf|dbf
dbg|dbg
dbh|dbh
dbi|dbi
dbj|dbj
dbk|dbk
dbl|dbl
dbm|dbm
dbn|dbn
dbo|dbo
dbp|dbp
dbq|dbq
dbr|dbr
dbs|dbs
dbt|dbt
dca|dca
dcb|dcb
dcc|dcc
dcd|dcd
dce|dce
dcf|dcf
dcg|dcg
dch|dch
dci|dci
dcj|dcj
dck|dck
dcl|dcl
dcm|dcm
dcn|dcn
dco|dco
dcp|dcp
dcq|dcq
dcr|dcr
dcs|dcs
dct|dct
dda|dda
ddb|ddb
ddc|ddc
ddd|ddd
dde|dde
ddf|ddf
ddg|ddg
ddh|ddh
ddi|ddi
ddj|ddj
ddk|ddk
ddl|ddl
ddm|ddm
ddn|ddn
ddo|ddo
ddp|ddp
ddq|ddq
ddr|ddr
dds|dds
ddt|ddt
dea|dea
deb|deb
dec|dec
ded|ded
dee|dee
def|def
deg|deg
deh|deh
dei|dei
dej|dej
dek|dek
del|del
dem|dem
den|den
deo|deo
dep|dep
deq|deq
der|der
des|des
det|det
dfa|dfa
dfb|dfb
dfc|dfc
dfd|dfd
dfe|dfe
dff|dff
dfg|dfg
dfh|dfh
dfi|dfi
dfj|dfj
dfk|dfk
dfl|dfl
dfm|dfm
dfn|dfn
dfo|dfo
dfp|dfp
dfq|dfq
dfr|dfr
dfs|dfs
dft|dft
dga|dga
dgb|dgb
dgc|dgc
dgd|dgd
dge|dge
dgf|dgf
dgg|dgg
dgh|dgh
dgi|dgi
dgj|dgj
dgk|dgk
dgl|dgl
dgm|dgm
dgn|dgn
dgo|dgo
dgp|dgp
dgq|dgq
dgr|dgr
dgs|dgs
dgt|dgt
dha|dha
dhb|dhb
dhc|dhc
dhd|dhd
dhe|dhe
dhf|dhf
dhg|dhg
dhh|dhh
dhi|dhi
dhj|dhj
dhk|dhk
dhl|dhl
dhm|dhm
dhn|dhn
dho|dho
dhp|dhp
dhq|dhq
dhr|dhr
dhs|dhs
dht|dht
dia|dia
dib|dib
dic|dic
did|did
die|die
dif|dif
dig|dig
dih|dih
dii|dii
dij|dij
dik|dik
dil|dil
dim|dim
din|din
dio|dio
dip|dip
diq|diq
dir|dir
dis|dis
dit|dit
dja|dja
djb|djb
djc|djc
djd|djd
dje|dje
djf|djf
djg|djg
djh|djh
dji|dji
djj|djj
djk|djk
djl|djl
djm|djm
djn|djn
djo|djo
djp|djp
djq|djq
djr|djr
djs|djs
djt|djt
dka|dka
dkb|dkb
dkc|dkc
dkd|dkd
dke|dke
dkf|dkf
dkg|dkg
dkh|dkh
dki|dki
dkj|dkj
dkk|dkk
dkl|dkl
dkm|dkm
dkn|dkn
dko|dko
dkp|dkp
dkq|dkq
dkr|dkr
dks|dks
dkt|dkt
dla|dla
dlb|dlb
dlc|dlc
dld|dld
dle|dle
dlf|dlf
dlg|dlg
dlh|dlh
dli|dli
dlj|dlj
dlk|dlk
dll|dll
dlm|dlm
dln|dln
dlo|dlo
dlp|dlp
dlq|dlq
dlr|dlr
dls|dls
dlt|dlt
dma|dma
dmb|dmb
dmc|dmc
dmd|dmd
dme|dme
dmf|dmf
dmg|dmg
dmh|dmh
dmi|dmi
dmj|dmj
dmk|dmk
dml|dml
dmm|dmm
dmn|dmn
dmo|dmo
dmp|dmp
dmq|dmq
dmr|dmr
dms|dms
dmt|dmt
dna|dna
dnb|dnb
dnc|dnc
dnd|dnd
dne|dne
dnf|dnf
dng|dng
dnh|dnh
dni|dni
dnj|dnj
dnk|dnk
dnl|dnl
dnm|dnm
dnn|dnn
dno|dno
dnp|dnp
dnq|dnq
dnr|dnr
dns|dns
dnt|dnt
doa|doa
dob|dob
doc|doc
dod|dod
doe|doe
dof|dof
dog|dog
doh|doh
doi|doi
doj|doj
dok|dok
dol|dol
dom|dom
don|don
doo|doo
dop|dop
doq|doq
dor|dor
dos|dos
dot|dot
dpa|dpa
dpb|dpb
dpc|dpc
dpd|dpd
dpe|dpe
dpf|dpf
dpg|dpg
dph|dph
dpi|dpi
dpj|dpj
dpk|dpk
dpl|dpl
dpm|dpm
dpn|dpn
dpo|dpo
dpp|dpp
dpq|dpq
dpr|dpr
dps|dps
dpt|dpt
dqa|dqa
dqb|dqb
dqc|dqc
dqd|dqd
dqe|dqe
dqf|dqf
dqg|dqg
dqh|dqh
dqi|dqi
dqj|dqj
dqk|dqk
dql|dql
dqm|dqm
dqn|dqn
dqo|dqo
dqp|dqp
dqq|dqq
dqr|dqr
dqs|dqs
dqt|dqt
dra|dra
drb|drb
drc|drc
drd|drd
dre|dre
drf|drf
drg|drg
drh|drh
dri|dri
drj|drj
drk|drk
drl|drl
drm|drm
drn|drn
dro|dro
drp|drp
drq|drq
drr|drr
drs|drs
drt|drt
dsa|dsa
dsb|dsb
dsc|dsc
dsd|dsd
dse|dse
dsf|dsf
dsg|dsg
dsh|dsh
dsi|dsi
dsj|dsj
dsk|dsk
dsl|dsl
dsm|dsm
dsn|dsn
dso|dso
dsp|dsp
dsq|dsq
dsr|dsr
dss|dss
dst|dst
dta|dta
dtb|dtb
dtc|dtc
dtd|dtd
dte|dte
dtf|dtf
dtg|dtg
dth|dth
dti|dti
dtj|dtj
dtk|dtk
dtl|dtl
dtm|dtm
dtn|dtn
dto|dto
dtp|dtp
dtq|dtq
dtr|dtr
dts|dts
dtt|dtt
eaa|eaa
eab|eab
eac|eac
ead|ead
eae|eae
eaf|eaf
eag|eag
eah|eah
eai|eai
eaj|eaj
eak|eak
eal|eal
eam|eam
ean|ean
eao|eao
eap|eap
eaq|eaq
ear|ear
eas|eas
eat|eat
eba|eba
ebb|ebb
ebc|ebc
ebd|ebd
ebe|ebe
ebf|ebf
ebg|ebg
ebh|ebh
ebi|ebi
ebj|ebj
ebk|ebk
ebl|ebl
ebm|ebm
ebn|ebn
ebo|ebo
ebp|ebp
ebq|ebq
ebr|ebr
ebs|ebs
ebt|ebt
eca|eca
ecb|ecb
ecc|ecc
ecd|ecd
ece|ece
ecf|ecf
ecg|ecg
ech|ech
eci|eci
ecj|ecj
eck|eck
ecl|ecl
ecm|ecm
ecn|ecn
eco|eco
ecp|ecp
ecq|ecq
ecr|ecr
ecs|ecs
ect|ect
eda|eda
edb|edb
edc|edc
edd|edd
ede|ede
edf|edf
edg|edg
edh|edh
edi|edi
edj|edj
edk|edk
edl|edl
edm|edm
edn|edn
edo|edo
edp|edp
edq|edq
edr|edr
eds|eds
edt|edt
eea|eea
eeb|eeb
eec|eec
eed|eed
eee|eee
eef|eef
eeg|eeg
eeh|eeh
eei|eei
eej|eej
eek|eek
eel|eel
eem|eem
een|een
eeo|eeo
eep|eep
eeq|eeq
eer|eer
ees|ees
eet|eet
efa|efa
efb|efb
efc|efc
efd|efd
efe|efe
eff|eff
efg|efg
efh|efh
efi|efi
efj|efj
efk|efk
efl|efl
efm|efm
efn|efn
efo|efo
efp|efp
efq|efq
efr|efr
efs|efs
eft|eft
ega|ega
egb|egb
egc|egc
egd|egd
ege|ege
egf|egf
egg|egg
egh|egh
egi|egi
egj|egj
egk|egk
egl|egl
egm|egm
egn|egn
ego|ego
egp|egp
egq|egq
egr|egr
egs|egs
egt|egt
eha|eha
ehb|ehb
ehc|ehc
ehd|ehd
ehe|ehe
ehf|ehf
ehg|ehg
ehh|ehh
ehi|ehi
ehj|ehj
ehk|ehk
ehl|ehl
ehm|ehm
ehn|ehn
eho|eho
ehp|ehp
ehq|ehq
ehr|ehr
ehs|ehs
eht|eht
eia|eia
eib|eib
eic|eic
eid|eid
eie|eie
eif|eif
eig|eig
eih|eih
eii|eii
eij|eij
eik|eik
eil|eil
eim|eim
ein|ein
eio|eio
eip|eip
eiq|eiq
eir|eir
eis|eis
eit|eit
eja|eja
ejb|ejb
ejc|ejc
ejd|ejd
eje|eje
ejf|ejf
ejg|ejg
ejh|ejh
eji|eji
ejj|ejj
ejk|ejk
ejl|ejl
ejm|ejm
ejn|ejn
ejo|ejo
ejp|ejp
ejq|ejq
ejr|ejr
ejs|ejs
ejt|ejt
eka|eka
ekb|ekb
ekc|ekc
ekd|ekd
eke|eke
ekf|ekf
ekg|ekg
ekh|ekh
eki|eki
ekj|ekj
ekk|ekk
ekl|ekl
ekm|ekm
ekn|ekn
eko|eko
ekp|ekp
ekq|ekq
ekr|ekr
eks|eks
ekt|ekt
ela|ela
elb|elb
elc|elc
eld|eld
ele|ele
elf|elf
elg|elg
elh|elh
eli|eli
elj|elj
elk|elk
ell|ell
elm|elm
eln|eln
elo|elo
elp|elp
elq|elq
elr|elr
els|els
elt|elt
ema|ema
emb|emb
emc|emc
emd|emd
eme|eme
emf|emf
emg|emg
emh|emh
emi|emi
emj|emj
emk|emk
eml|eml
emm|emm
emn|emn
emo|emo
emp|emp
emq|emq
emr|emr
ems|ems
emt|emt
ena|ena
enb|enb
enc|enc
end|end
ene|ene
enf|enf
eng|eng
enh|enh
eni|eni
enj|enj
enk|enk
enl|enl
enm|enm
enn|enn
eno|eno
enp|enp
enq|enq
enr|enr
ens|ens
ent|ent
eoa|eoa
eob|eob
eoc|eoc
eod|eod
eoe|eoe
eof|eof
eog|eog
eoh|eoh
eoi|eoi
eoj|eoj
eok|eok
eol|eol
eom|eom
eon|eon
eoo|eoo
eop|eop
eoq|eoq
eor|eor
eos|eos
eot|eot
epa|epa
epb|epb
epc|epc
epd|epd
epe|epe
epf|epf
epg|epg
eph|eph
epi|epi
epj|epj
epk|epk
epl|epl
epm|epm
epn|epn
epo|epo
epp|epp
epq|epq
epr|epr
eps|eps
ept|ept
eqa|eqa
eqb|eqb
eqc|eqc
eqd|eqd
eqe|eqe
eqf|eqf
eqg|eqg
eqh|eqh
eqi|eqi
eqj|eqj
eqk|eqk
eql|eql
eqm|eqm
eqn|eqn
eqo|eqo
eqp|eqp
eqq|eqq
eqr|eqr
eqs|eqs
eqt|eqt
era|era
erb|erb
erc|erc
erd|erd
ere|ere
erf|erf
erg|erg
erh|erh
eri|eri
erj|erj
erk|erk
erl|erl
erm|erm
ern|ern
ero|ero
erp|erp
erq|erq
err|err
ers|ers
ert|ert
esa|esa
esb|esb
esc|esc
esd|esd
ese|ese
esf|esf
esg|esg
esh|esh
esi|esi
esj|esj
esk|esk
esl|esl
esm|esm
esn|esn
eso|eso
esp|esp
esq|esq
esr|esr
ess|ess
est|est
eta|eta
etb|etb
etc|etc
etd|etd
ete|ete
etf|etf
etg|etg
eth|eth
eti|eti
etj|etj
etk|etk
etl|etl
etm|etm
etn|etn
eto|eto
etp|etp
etq|etq
etr|etr
ets|ets
ett|ett
faa|faa
fab|fab
fac|fac
fad|fad
fae|fae
faf|faf
fag|fag
fah|fah
fai|fai
faj|faj
fak|fak
fal|fal
fam|fam
fan|fan
fao|fao
fap|fap
faq|faq
far|far
fas|fas
fat|fat
fba|fba
fbb|fbb
fbc|fbc
fbd|fbd
fbe|fbe
fbf|fbf
fbg|fbg
fbh|fbh
fbi|fbi
fbj|fbj
fbk|fbk
fbl|fbl
fbm|fbm
fbn|fbn
fbo|fbo
fbp|fbp
fbq|fbq
fbr|fbr
fbs|fbs
fbt|fbt
fca|fca
fcb|fcb
fcc|fcc
fcd|fcd
fce|fce
fcf|fcf
fcg|fcg
fch|fch
fci|fci
fcj|fcj
fck|fck
fcl|fcl
fcm|fcm
fcn|fcn
fco|fco
fcp|fcp
fcq|fcq
fcr|fcr
fcs|fcs
fct|fct
fda|fda
fdb|fdb
fdc|fdc
fdd|fdd
fde|fde
fdf|fdf
fdg|fdg
fdh|fdh
fdi|fdi
fdj|fdj
fdk|fdk
fdl|fdl
fdm|fdm
fdn|fdn
fdo|fdo
fdp|fdp
fdq|fdq
fdr|fdr
fds|fds
fdt|fdt
fea|fea
feb|feb
fec|fec
fed|fed
fee|fee
fef|fef
feg|feg
feh|feh
fei|fei
fej|fej
fek|fek
fel|fel
fem|fem
fen|fen
feo|feo
fep|fep
feq|feq
fer|fer
fes|fes
fet|fet
ffa|ffa
ffb|ffb
ffc|ffc
ffd|ffd
ffe|ffe
fff|fff
ffg|ffg
ffh|ffh
ffi|ffi
ffj|ffj
ffk|ffk
ffl|ffl
ffm|ffm
ffn|ffn
ffo|ffo
ffp|ffp
ffq|ffq
ffr|ffr
ffs|ffs
fft|fft
fga|fga
fgb|fgb
fgc|fgc
fgd|fgd
fge|fge
fgf|fgf
fgg|fgg
fgh|fgh
fgi|fgi
fgj|fgj
fgk|fgk
fgl|fgl
fgm|fgm
fgn|fgn
fgo|fgo
fgp|fgp
fgq|fgq
fgr|fgr
fgs|fgs
fgt|fgt
fha|fha
fhb|fhb
fhc|fhc
fhd|fhd
fhe|fhe
fhf|fhf
fhg|fhg
fhh|fhh
fhi|fhi
fhj|fhj
fhk|fhk
fhl|fhl
fhm|fhm
fhn|fhn
fho|fho
fhp|fhp
fhq|fhq
fhr|fhr
fhs|fhs
fht|fht
fia|fia
fib|fib
fic|fic
fid|fid
fie|fie
fif|fif
fig|fig
fih|fih
fii|fii
fij|fij
fik|fik
fil|fil
fim|fim
fin|fin
fio|fio
fip|fip
fiq|fiq
fir|fir
fis|fis
fit|fit
fja|fja
fjb|fjb
fjc|fjc
fjd|fjd
fje|fje
fjf|fjf
fjg|fjg
fjh|fjh
fji|fji
fjj|fjj
fjk|fjk
fjl|fjl
fjm|fjm
fjn|fjn
fjo|fjo
fjp|fjp
fjq|fjq
fjr|fjr
fjs|fjs
fjt|fjt
fka|fka
fkb|fkb
fkc|fkc
fkd|fkd
fke|fke
fkf|fkf
fkg|fkg
fkh|fkh
fki|fki
fkj|fkj
fkk|fkk
fkl|fkl
fkm|fkm
fkn|fkn
fko|fko
fkp|fkp
fkq|fkq
fkr|fkr
fks|fks
fkt|fkt
fla|fla
flb|flb
flc|flc
fld|fld
fle|fle
flf|flf
flg|flg
flh|flh
fli|fli
flj|flj
flk|flk
fll|fll
flm|flm
fln|fln
flo|flo
flp|flp
flq|flq
flr|flr
fls|fls
flt|flt
fma|fma
fmb|fmb
fmc|fmc
fmd|fmd
fme|fme
fmf|fmf
fmg|fmg
fmh|fmh
fmi|fmi
fmj|fmj
fmk|fmk
fml|fml
fmm|fmm
fmn|fmn
fmo|fmo
fmp|fmp
fmq|fmq
fmr|fmr
fms|fms
fmt|fmt
fna|fna
fnb|fnb
fnc|fnc
fnd|fnd
fne|fne
fnf|fnf
fng|fng
fnh|fnh
fni|fni
fnj|fnj
fnk|fnk
fnl|fnl
fnm|fnm
fnn|fnn
fno|fno
fnp|fnp
fnq|fnq
fnr|fnr
fns|fns
fnt|fnt
foa|foa
fob|fob
foc|foc
fod|fod
foe|foe
fof|fof
fog|fog
foh|foh
foi|foi
foj|foj
fok|fok
fol|fol
fom|fom
fon|fon
foo|foo
fop|fop
foq|foq
for|for
fos|fos
fot|fot
fpa|fpa
fpb|fpb
fpc|fpc
fpd|fpd
fpe|fpe
fpf|fpf
fpg|fpg
fph|fph
fpi|fpi
fpj|fpj
fpk|fpk
fpl|fpl
fpm|fpm
fpn|fpn
fpo|fpo
fpp|fpp
fpq|fpq
fpr|fpr
fps|fps
fpt|fpt
fqa|fqa
fqb|fqb
fqc|fqc
fqd|fqd
fqe|fqe
fqf|fqf
fqg|fqg
fqh|fqh
fqi|fqi
fqj|fqj
fqk|fqk
fql|fql
fqm|fqm
fqn|fqn
fqo|fqo
fqp|fqp
fqq|fqq
fqr|fqr
fqs|fqs
fqt|fqt
fra|fra
frb|frb
frc|frc
frd|frd
fre|fre
frf|frf
frg|frg
frh|frh
fri|fri
frj|frj
frk|frk
frl|frl
frm|frm
frn|frn
fro|fro
frp|frp
frq|frq
frr|frr
frs|frs
frt|frt
fsa|fsa
fsb|fsb
fsc|fsc
fsd|fsd
fse|fse
fsf|fsf
fsg|fsg
fsh|fsh
fsi|fsi
fsj|fsj
fsk|fsk
fsl|fsl
fsm|fsm
fsn|fsn
fso|fso
fsp|fsp
fsq|fsq
fsr|fsr
fss|fss
fst|fst
fta|fta
ftb|ftb
ftc|ftc
ftd|ftd
fte|fte
ftf|ftf
ftg|ftg
fth|fth
fti|fti
ftj|ftj
ftk|ftk
ftl|ftl
ftm|ftm
ftn|ftn
fto|fto
ftp|ftp
ftq|ftq
ftr|ftr
fts|fts
ftt|ftt
gaa|gaa
gab|gab
gac|gac
gad|gad
gae|gae
gaf|gaf
gag|gag
gah|gah
gai|gai
gaj|gaj
gak|gak
gal|gal
gam|gam
gan|gan
gao|gao
gap|gap
gaq|gaq
gar|gar
gas|gas
gat|gat
gba|gba
gbb|gbb
gbc|gbc
gbd|gbd
gbe|gbe
gbf|gbf
gbg|gbg
gbh|gbh
gbi|gbi
gbj|gbj
gbk|gbk
gbl|gbl
gbm|gbm
gbn|gbn
gbo|gbo
gbp|gbp
gbq|gbq
gbr|gbr
gbs|gbs
gbt|gbt
gca|gca
gcb|gcb
gcc|gcc
gcd|gcd
gce|gce
gcf|gcf
gcg|gcg
gch|gch
gci|gci
gcj|gcj
gck|gck
gcl|gcl
gcm|gcm
gcn|gcn
gco|gco
gcp|gcp
gcq|gcq
gcr|gcr
gcs|gcs
gct|gct
gda|gda
gdb|gdb
gdc|gdc
gdd|gdd
gde|gde
gdf|gdf
gdg|gdg
gdh|gdh
gdi|gdi
gdj|gdj
gdk|gdk
gdl|gdl
gdm|gdm
gdn|gdn
gdo|gdo
gdp|gdp
gdq|gdq
gdr|gdr
gds|gds
gdt|gdt
gea|gea
geb|geb
gec|gec
ged|ged
gee|gee
gef|gef
geg|geg
geh|geh
gei|gei
gej|gej
gek|gek
gel|gel
gem|gem
gen|gen
geo|geo
gep|gep
geq|geq
ger|ger
ges|ges
get|get
gfa|gfa
gfb|gfb
gfc|gfc
gfd|gfd
gfe|gfe
gff|gff
gfg|gfg
gfh|gfh
gfi|gfi
gfj|gfj
gfk|gfk
gfl|gfl
gfm|gfm
gfn|gfn
gfo|gfo
gfp|gfp
gfq|gfq
gfr|gfr
gfs|gfs
gft|gft
gga|gga
ggb|ggb
ggc|ggc
ggd|ggd
gge|gge
ggf|ggf
ggg|ggg
ggh|ggh
ggi|ggi
ggj|ggj
ggk|ggk
ggl|ggl
ggm|ggm
ggn|ggn
ggo|ggo
ggp|ggp
ggq|ggq
ggr|ggr
ggs|ggs
ggt|ggt
gha|gha
ghb|ghb
ghc|ghc
ghd|ghd
ghe|ghe
ghf|ghf
ghg|ghg
ghh|ghh
ghi|ghi
ghj|ghj
ghk|ghk
ghl|ghl
ghm|ghm
ghn|ghn
gho|gho
ghp|ghp
ghq|ghq
ghr|ghr
ghs|ghs
ght|ght
gia|gia
gib|gib
gic|gic
gid|gid
gie|gie
gif|gif
gig|gig
gih|gih
gii|gii
gij|gij
gik|gik
gil|gil
gim|gim
gin|gin
gio|gio
gip|gip
giq|giq
gir|gir
gis|gis
git|git
gja|gja
gjb|gjb
gjc|gjc
gjd|gjd
gje|gje
gjf|gjf
gjg|gjg
gjh|gjh
gji|gji
gjj|gjj
gjk|gjk
gjl|gjl
gjm|gjm
gjn|gjn
gjo|gjo
gjp|gjp
gjq|gjq
gjr|gjr
gjs|gjs
gjt|gjt
gka|gka
gkb|gkb
gkc|gkc
gkd|gkd
gke|gke
gkf|gkf
gkg|gkg
gkh|gkh
gki|gki
gkj|gkj
gkk|gkk
gkl|gkl
gkm|gkm
gkn|gkn
gko|gko
gkp|gkp
gkq|gkq
gkr|gkr
gks|gks
gkt|gkt
gla|gla
glb|glb
glc|glc
gld|gld
gle|gle
glf|glf
glg|glg
glh|glh
gli|gli
glj|glj
glk|glk
gll|gll
glm|glm
gln|gln
glo|glo
glp|glp
glq|glq
glr|glr
gls|gls
glt|glt
gma|gma
gmb|gmb
gmc|gmc
gmd|gmd
gme|gme
gmf|gmf
gmg|gmg
gmh|gmh
gmi|gmi
gmj|gmj
gmk|gmk
gml|gml
gmm|gmm
gmn|gmn
gmo|gmo
gmp|gmp
gmq|gmq
gmr|gmr
gms|gms
gmt|gmt
gna|gna
gnb|gnb
gnc|gnc
gnd|gnd
gne|gne
gnf|gnf
gng|gng
gnh|gnh
gni|gni
gnj|gnj
gnk|gnk
gnl|gnl
gnm|gnm
gnn|gnn
gno|gno
gnp|gnp
gnq|gnq
gnr|gnr
gns|gns
gnt|gnt
goa|goa
gob|gob
goc|goc
god|god
goe|goe
gof|gof
gog|gog
goh|goh
goi|goi
goj|goj
gok|gok
gol|gol
gom|gom
gon|gon
goo|goo
gop|gop
goq|goq
gor|gor
gos|gos
got|got
gpa|gpa
gpb|gpb
gpc|gpc
gpd|gpd
gpe|gpe
gpf|gpf
gpg|gpg
gph|gph
gpi|gpi
gpj|gpj
gpk|gpk
gpl|gpl
gpm|gpm
gpn|gpn
gpo|gpo
gpp|gpp
gpq|gpq
gpr|gpr
gps|gps
gpt|gpt
gqa|gqa
gqb|gqb
gqc|gqc
gqd|gqd
gqe|gqe
gqf|gqf
gqg|gqg
gqh|gqh
gqi|gqi
gqj|gqj
gqk|gqk
gql|gql
gqm|gqm
gqn|gqn
gqo|gqo
gqp|gqp
gqq|gqq
gqr|gqr
gqs|gqs
gqt|gqt
gra|gra
grb|grb
grc|grc
grd|grd
gre|gre
grf|grf
grg|grg
grh|grh
gri|gri
grj|grj
grk|grk
grl|grl
grm|grm
grn|grn
gro|gro
grp|grp
grq|grq
grr|grr
grs|grs
grt|grt
gsa|gsa
gsb|gsb
gsc|gsc
gsd|gsd
gse|gse
gsf|gsf
gsg|gsg
gsh|gsh
gsi|gsi
gsj|gsj
gsk|gsk
gsl|gsl
gsm|gsm
gsn|gsn
gso|gso
gsp|gsp
gsq|gsq
gsr|gsr
gss|gss
gst|gst
gta|gta
gtb|gtb
gtc|gtc
gtd|gtd
gte|gte
gtf|gtf
gtg|gtg
gth|gth
gti|gti
gtj|gtj
gtk|gtk
gtl|gtl
gtm|gtm
gtn|gtn
gto|gto
gtp|gtp
gtq|gtq
gtr|gtr
gts|gts
gtt|gtt
haa|haa
hab|hab
hac|hac
had|had
hae|hae
haf|haf
hag|hag
hah|hah
hai|hai
haj|haj
hak|hak
hal|hal
ham|ham
han|han
hao|hao
hap|hap
haq|haq
har|har
has|has
hat|hat
hba|hba
hbb|hbb
hbc|hbc
hbd|hbd
hbe|hbe
hbf|hbf
hbg|hbg
hbh|hbh
hbi|hbi
hbj|hbj
hbk|hbk
hbl|hbl
hbm|hbm
hbn|hbn
hbo|hbo
hbp|hbp
hbq|hbq
hbr|hbr
hbs|hbs
hbt|hbt
hca|hca
hcb|hcb
hcc|hcc
hcd|hcd
hce|hce
hcf|hcf
hcg|hcg
hch|hch
hci|hci
hcj|hcj
hck|hck
hcl|hcl
hcm|hcm
hcn|hcn
hco|hco
hcp|hcp
hcq|hcq
hcr|hcr
hcs|hcs
hct|hct
hda|hda
hdb|hdb
hdc|hdc
hdd|hdd
hde|hde
hdf|hdf
hdg|hdg
hdh|hdh
hdi|hdi
hdj|hdj
hdk|hdk
hdl|hdl
hdm|hdm
hdn|hdn
hdo|hdo
hdp|hdp
hdq|hdq
hdr|hdr
hds|hds
hdt|hdt
hea|hea
heb|heb
hec|hec
hed|hed
hee|hee
hef|hef
heg|heg
heh|heh
hei|hei
hej|hej
hek|hek
hel|hel
hem|hem
hen|hen
heo|heo
hep|hep
heq|heq
her|her
hes|hes
het|het
hfa|hfa
hfb|hfb
hfc|hfc
hfd|hfd
hfe|hfe
hff|hff
hfg|hfg
hfh|hfh
hfi|hfi
hfj|hfj
hfk|hfk
hfl|hfl
hfm|hfm
hfn|hfn
hfo|hfo
hfp|hfp
hfq|hfq
hfr|hfr
hfs|hfs
hft|hft
hga|hga
hgb|hgb
hgc|hgc
hgd|hgd
hge|hge
hgf|hgf
hgg|hgg
hgh|hgh
hgi|hgi
hgj|hgj
hgk|hgk
hgl|hgl
hgm|hgm
hgn|hgn
hgo|hgo
hgp|hgp
hgq|hgq
hgr|hgr
hgs|hgs
hgt|hgt
hha|hha
hhb|hhb
hhc|hhc
hhd|hhd
hhe|hhe
hhf|hhf
hhg|hhg
hhh|hhh
hhi|hhi
hhj|hhj
hhk|hhk
hhl|hhl
hhm|hhm
hhn|hhn
hho|hho
hhp|hhp
hhq|hhq
hhr|hhr
hhs|hhs
hht|hht
hia|hia
hib|hib
hic|hic
hid|hid
hie|hie
hif|hif
hig|hig
hih|hih
hii|hii
hij|hij
hik|hik
hil|hil
him|him
hin|hin
hio|hio
hip|hip
hiq|hiq
hir|hir
his|his
hit|hit
hja|hja
hjb|hjb
hjc|hjc
hjd|hjd
hje|hje
hjf|hjf
hjg|hjg
hjh|hjh
hji|hji
hjj|hjj
hjk|hjk
hjl|hjl
hjm|hjm
hjn|hjn
hjo|hjo
hjp|hjp
hjq|hjq
hjr|hjr
hjs|hjs
hjt|hjt
hka|hka
hkb|hkb
hkc|hkc
hkd|hkd
hke|hke
hkf|hkf
hkg|hkg
hkh|hkh
hki|hki
hkj|hkj
hkk|hkk
hkl|hkl
hkm|hkm
hkn|hkn
hko|hko
hkp|hkp
hkq|hkq
hkr|hkr
hks|hks
hkt|hkt
hla|hla
hlb|hlb
hlc|hlc
hld|hld
hle|hle
hlf|hlf
hlg|hlg
hlh|hlh
hli|hli
hlj|hlj
hlk|hlk
hll|hll
hlm|hlm
hln|hln
hlo|hlo
hlp|hlp
hlq|hlq
hlr|hlr
hls|hls
hlt|hlt
hma|hma
hmb|hmb
hmc|hmc
hmd|hmd
hme|hme
hmf|hmf
hmg|hmg
hmh|hmh
hmi|hmi
hmj|hmj
hmk|hmk
hml|hml
hmm|hmm
hmn|hmn
hmo|hmo
hmp|hmp
hmq|hmq
hmr|hmr
hms|hms
hmt|hmt
hna|hna
hnb|hnb
hnc|hnc
hnd|hnd
hne|hne
hnf|hnf
hng|hng
hnh|hnh
hni|hni
hnj|hnj
hnk|hnk
hnl|hnl
hnm|hnm
hnn|hnn
hno|hno
hnp|hnp
hnq|hnq
hnr|hnr
hns|hns
hnt|hnt
hoa|hoa
hob|hob
hoc|hoc
hod|hod
hoe|hoe
hof|hof
hog|hog
hoh|hoh
hoi|hoi
hoj|hoj
hok|hok
hol|hol
hom|hom
hon|hon
hoo|hoo
hop|hop
hoq|hoq
hor|hor
hos|hos
hot|hot
hpa|hpa
hpb|hpb
hpc|hpc
hpd|hpd
hpe|hpe
hpf|hpf
hpg|hpg
hph|hph
hpi|hpi
hpj|hpj
hpk|hpk
hpl|hpl
hpm|hpm
hpn|hpn
hpo|hpo
hpp|hpp
hpq|hpq
hpr|hpr
hps|hps
hpt|hpt
hqa|hqa
hqb|hqb
hqc|hqc
hqd|hqd
hqe|hqe
hqf|hqf
hqg|hqg
hqh|hqh
hqi|hqi
hqj|hqj
hqk|hqk
hql|hql
hqm|hqm
hqn|hqn
hqo|hqo
hqp|hqp
hqq|hqq
hqr|hqr
hqs|hqs
hqt|hqt
hra|hra
hrb|hrb
hrc|hrc
hrd|hrd
hre|hre
hrf|hrf
hrg|hrg
hrh|hrh
hri|hri
hrj|hrj
hrk|hrk
hrl|hrl
hrm|hrm
hrn|hrn
hro|hro
hrp|hrp
hrq|hrq
hrr|hrr
hrs|hrs
hrt|hrt
hsa|hsa
hsb|hsb
hsc|hsc
hsd|hsd
hse|hse
hsf|hsf
hsg|hsg
hsh|hsh
hsi|hsi
hsj|hsj
hsk|hsk
hsl|hsl
hsm|hsm
hsn|hsn
hso|hso
hsp|hsp
hsq|hsq
hsr|hsr
hss|hss
hst|hst
hta|hta
htb|htb
htc|htc
htd|htd
hte|hte
htf|htf
htg|htg
hth|hth
hti|hti
htj|htj
htk|htk
htl|htl
htm|htm
htn|htn
hto|hto
htp|htp
htq|htq
htr|htr
hts|hts
htt|htt
iaa|iaa
iab|iab
iac|iac
iad|iad
iae|iae
iaf|iaf
iag|iag
iah|iah
iai|iai
iaj|iaj
iak|iak
ial|ial
iam|iam
ian|ian
iao|iao
iap|iap
iaq|iaq
iar|iar
ias|ias
iat|iat
iba|iba
ibb|ibb
ibc|ibc
ibd|ibd
ibe|ibe
ibf|ibf
ibg|ibg
ibh|ibh
ibi|ibi
ibj|ibj
ibk|ibk
ibl|ibl
ibm|ibm
ibn|ibn
ibo|ibo
ibp|ibp
ibq|ibq
ibr|ibr
ibs|ibs
ibt|ibt
ica|ica
icb|icb
icc|icc
icd|icd
ice|ice
icf|icf
icg|icg
ich|ich
ici|ici
icj|icj
ick|ick
icl|icl
icm|icm
icn|icn
ico|ico
icp|icp
icq|icq
icr|icr
ics|ics
ict|ict
ida|ida
idb|idb
idc|idc
idd|idd
ide|ide
idf|idf
idg|idg
idh|idh
idi|idi
idj|idj
idk|idk
idl|idl
idm|idm
idn|idn
ido|ido
idp|idp
idq|idq
idr|idr
ids|ids
idt|idt
iea|iea
ieb|ieb
iec|iec
ied|ied
iee|iee
ief|ief
ieg|ieg
ieh|ieh
iei|iei
iej|iej
iek|iek
iel|iel
iem|iem
ien|ien
ieo|ieo
iep|iep
ieq|ieq
ier|ier
ies|ies
iet|iet
ifa|ifa
ifb|ifb
ifc|ifc
ifd|ifd
ife|ife
iff|iff
ifg|ifg
ifh|ifh
ifi|ifi
ifj|ifj
ifk|ifk
ifl|ifl
ifm|ifm
ifn|ifn
ifo|ifo
ifp|ifp
ifq|ifq
ifr|ifr
ifs|ifs
ift|ift
iga|iga
igb|igb
igc|igc
igd|igd
ige|ige
igf|igf
igg|igg
igh|igh
igi|igi
igj|igj
igk|igk
igl|igl
igm|igm
ign|ign
igo|igo
igp|igp
igq|igq
igr|igr
igs|igs
igt|igt
iha|iha
ihb|ihb
ihc|ihc
ihd|ihd
ihe|ihe
ihf|ihf
ihg|ihg
ihh|ihh
ihi|ihi
ihj|ihj
ihk|ihk
ihl|ihl
ihm|ihm
ihn|ihn
iho|iho
ihp|ihp
ihq|ihq
ihr|ihr
ihs|ihs
iht|iht
iia|iia
iib|iib
iic|iic
iid|iid
iie|iie
iif|iif
iig|iig
iih|iih
iii|iii
iij|iij
iik|iik
iil|iil
iim|iim
iin|iin
iio|iio
iip|iip
iiq|iiq
iir|iir
iis|iis
iit|iit
ija|ija
ijb|ijb
ijc|ijc
ijd|ijd
ije|ije
ijf|ijf
ijg|ijg
ijh|ijh
iji|iji
ijj|ijj
ijk|ijk
ijl|ijl
ijm|ijm
ijn|ijn
ijo|ijo
ijp|ijp
ijq|ijq
ijr|ijr
ijs|ijs
ijt|ijt
ika|ika
ikb|ikb
ikc|ikc
ikd|ikd
ike|ike
ikf|ikf
ikg|ikg
ikh|ikh
iki|iki
ikj|ikj
ikk|ikk
ikl|ikl
ikm|ikm
ikn|ikn
iko|iko
ikp|ikp
ikq|ikq
ikr|ikr
iks|iks
ikt|ikt
ila|ila
ilb|ilb
ilc|ilc
ild|ild
ile|ile
ilf|ilf
ilg|ilg
ilh|ilh
ili|ili
ilj|ilj
ilk|ilk
ill|ill
ilm|ilm
iln|iln
ilo|ilo
ilp|ilp
ilq|ilq
ilr|ilr
ils|ils
ilt|ilt
ima|ima
imb|imb
imc|imc
imd|imd
ime|ime
imf|imf
img|img
imh|imh
imi|imi
imj|imj
imk|imk
iml|iml
imm|imm
imn|imn
imo|imo
imp|imp
imq|imq
imr|imr
ims|ims
imt|imt
ina|ina
inb|inb
inc|inc
ind|ind
ine|ine
inf|inf
ing|ing
inh|inh
ini|ini
inj|inj
ink|ink
inl|inl
inm|inm
inn|inn
ino|ino
inp|inp
inq|inq
inr|inr
ins|ins
int|int
ioa|ioa
iob|iob
ioc|ioc
iod|iod
ioe|ioe
iof|iof
iog|iog
ioh|ioh
ioi|ioi
ioj|ioj
iok|iok
iol|iol
iom|iom
ion|ion
ioo|ioo
iop|iop
ioq|ioq
ior|ior
ios|ios
iot|iot
ipa|ipa
ipb|ipb
ipc|ipc
ipd|ipd
ipe|ipe
ipf|ipf
ipg|ipg
iph|iph
ipi|ipi
ipj|ipj
ipk|ipk
ipl|ipl
ipm|ipm
ipn|ipn
ipo|ipo
ipp|ipp
ipq|ipq
ipr|ipr
ips|ips
ipt|ipt
iqa|iqa
iqb|iqb
iqc|iqc
iqd|iqd
iqe|iqe
iqf|iqf
iqg|iqg
iqh|iqh
iqi|iqi
iqj|iqj
iqk|iqk
iql|iql
iqm|iqm
iqn|iqn
iqo|iqo
iqp|iqp
iqq|iqq
iqr|iqr
iqs|iqs
iqt|iqt
ira|ira
irb|irb
irc|irc
ird|ird
ire|ire
irf|irf
irg|irg
irh|irh
iri|iri
irj|irj
irk|irk
irl|irl
irm|irm
irn|irn
iro|iro
irp|irp
irq|irq
irr|irr
irs|irs
irt|irt
isa|isa
isb|isb
isc|isc
isd|isd
ise|ise
isf|isf
isg|isg
ish|ish
isi|isi
isj|isj
isk|isk
isl|isl
ism|ism
isn|isn
iso|iso
isp|isp
isq|isq
isr|isr
iss|iss
ist|ist
ita|ita
itb|itb
itc|itc
itd|itd
ite|ite
itf|itf
itg|itg
ith|ith
iti|iti
itj|itj
itk|itk
itl|itl
itm|itm
itn|itn
ito|ito
itp|itp
itq|itq
itr|itr
its|its
itt|itt
jaa|jaa
jab|jab
jac|jac
jad|jad
jae|jae
jaf|jaf
jag|jag
jah|jah
jai|jai
jaj|jaj
jak|jak
jal|jal
jam|jam
jan|jan
jao|jao
jap|jap
jaq|jaq
jar|jar
jas|jas
jat|jat
jba|jba
jbb|jbb
jbc|jbc
jbd|jbd
jbe|jbe
jbf|jbf
jbg|jbg
jbh|jbh
jbi|jbi
jbj|jbj
jbk|jbk
jbl|jbl
jbm|jbm
jbn|jbn
jbo|jbo
jbp|jbp
jbq|jbq
jbr|jbr
jbs|jbs
jbt|jbt
jca|jca
jcb|jcb
jcc|jcc
jcd|jcd
jce|jce
jcf|jcf
jcg|jcg
jch|jch
jci|jci
jcj|jcj
jck|jck
jcl|jcl
jcm|jcm
jcn|jcn
jco|jco
jcp|jcp
jcq|jcq
jcr|jcr
jcs|jcs
jct|jct
jda|jda
jdb|jdb
jdc|jdc
jdd|jdd
jde|jde
jdf|jdf
jdg|jdg
jdh|jdh
jdi|jdi
jdj|jdj
jdk|jdk
jdl|jdl
jdm|jdm
jdn|jdn
jdo|jdo
jdp|jdp
jdq|jdq
jdr|jdr
jds|jds
jdt|jdt
jea|jea
jeb|jeb
jec|jec
jed|jed
jee|jee
jef|jef
jeg|jeg
jeh|jeh
jei|jei
jej|jej
jek|jek
jel|jel
jem|jem
jen|jen
jeo|jeo
jep|jep
jeq|jeq
jer|jer
jes|jes
jet|jet
jfa|jfa
jfb|jfb
jfc|jfc
jfd|jfd
jfe|jfe
jff|jff
jfg|jfg
jfh|jfh
jfi|jfi
jfj|jfj
jfk|jfk
jfl|jfl
jfm|jfm
jfn|jfn
jfo|jfo
jfp|jfp
jfq|jfq
jfr|jfr
jfs|jfs
jft|jft
jga|jga
jgb|jgb
jgc|jgc
jgd|jgd
jge|jge
jgf|jgf
jgg|jgg
jgh|jgh
jgi|jgi
jgj|jgj
jgk|jgk
jgl|jgl
jgm|jgm
jgn|jgn
jgo|jgo
jgp|jgp
jgq|jgq
jgr|jgr
jgs|jgs
jgt|jgt
jha|jha
jhb|jhb
jhc|jhc
jhd|jhd
jhe|jhe
jhf|jhf
jhg|jhg
jhh|jhh
jhi|jhi
jhj|jhj
jhk|jhk
jhl|jhl
jhm|jhm
jhn|jhn
jho|jho
jhp|jhp
jhq|jhq
jhr|jhr
jhs|jhs
jht|jht
jia|jia
jib|jib
jic|jic
jid|jid
jie|jie
jif|jif
jig|jig
jih|jih
jii|jii
jij|jij
jik|jik
jil|jil
jim|jim
jin|jin
jio|jio
jip|jip
jiq|jiq
jir|jir
jis|jis
jit|jit
jja|jja
jjb|jjb
jjc|jjc
jjd|jjd
jje|jje
jjf|jjf
jjg|jjg
jjh|jjh
jji|jji
jjj|jjj
jjk|jjk
jjl|jjl
jjm|jjm
jjn|jjn
jjo|jjo
jjp|jjp
jjq|jjq
jjr|jjr
jjs|jjs
jjt|jjt
jka|jka
jkb|jkb
jkc|jkc
jkd|jkd
jke|jke
jkf|jkf
jkg|jkg
jkh|jkh
jki|jki
jkj|jkj
jkk|jkk
jkl|jkl
jkm|jkm
jkn|jkn
jko|jko
jkp|jkp
jkq|jkq
jkr|jkr
jks|jks
jkt|jkt
jla|jla
jlb|jlb
jlc|jlc
jld|jld
jle|jle
jlf|jlf
jlg|jlg
jlh|jlh
jli|jli
jlj|jlj
jlk|jlk
jll|jll
jlm|jlm
jln|jln
jlo|jlo
jlp|jlp
jlq|jlq
jlr|jlr
jls|jls
jlt|jlt
jma|jma
jmb|jmb
jmc|jmc
jmd|jmd
jme|jme
jmf|jmf
jmg|jmg
jmh|jmh
jmi|jmi
jmj|jmj
jmk|jmk
jml|jml
jmm|jmm
jmn|jmn
jmo|jmo
jmp|jmp
jmq|jmq
jmr|jmr
jms|jms
jmt|jmt
jna|jna
jnb|jnb
jnc|jnc
jnd|jnd
jne|jne
jnf|jnf
jng|jng
jnh|jnh
jni|jni
jnj|jnj
jnk|jnk
jnl|jnl
jnm|jnm
jnn|jnn
jno|jno
jnp|jnp
jnq|jnq
jnr|jnr
jns|jns
jnt|jnt
joa|joa
job|job
joc|joc
jod|jod
joe|joe
jof|jof
jog|jog
joh|joh
joi|joi
joj|joj
jok|jok
jol|jol
jom|jom
jon|jon
joo|joo
jop|jop
joq|joq
jor|jor
jos|jos
jot|jot
jpa|jpa
jpb|jpb
jpc|jpc
jpd|jpd
jpe|jpe
jpf|jpf
jpg|jpg
jph|jph
jpi|jpi
jpj|jpj
jpk|jpk
jpl|jpl
jpm|jpm
jpn|jpn
jpo|jpo
jpp|jpp
jpq|jpq
jpr|jpr
jps|jps
jpt|jpt
jqa|jqa
jqb|jqb
jqc|jqc
jqd|jqd
jqe|jqe
jqf|jqf
jqg|jqg
jqh|jqh
jqi|jqi
jqj|jqj
jqk|jqk
jql|jql
jqm|jqm
jqn|jqn
jqo|jqo
jqp|jqp
jqq|jqq
jqr|jqr
jqs|jqs
jqt|jqt
jra|jra
jrb|jrb
jrc|jrc
jrd|jrd
jre|jre
jrf|jrf
jrg|jrg
jrh|jrh
jri|jri
jrj|jrj
jrk|jrk
jrl|jrl
jrm|jrm
jrn|jrn
jro|jro
jrp|jrp
jrq|jrq
jrr|jrr
jrs|jrs
jrt|jrt
jsa|jsa
jsb|jsb
jsc|jsc
jsd|jsd
jse|jse
jsf|jsf
jsg|jsg
jsh|jsh
jsi|jsi
jsj|jsj
jsk|jsk
jsl|jsl
jsm|jsm
jsn|jsn
jso|jso
jsp|jsp
jsq|jsq
jsr|jsr
jss|jss
jst|jst
jta|jta
jtb|jtb
jtc|jtc
jtd|jtd
jte|jte
jtf|jtf
jtg|jtg
jth|jth
jti|jti
jtj|jtj
jtk|jtk
jtl|jtl
jtm|jtm
jtn|jtn
jto|jto
jtp|jtp
jtq|jtq
jtr|jtr
jts|jts
jtt|jtt
kaa|kaa
kab|kab
kac|kac
kad|kad
kae|kae
kaf|kaf
kag|kag
kah|kah
kai|kai
kaj|kaj
kak|kak
kal|kal
kam|kam
kan|kan
kao|kao
kap|kap
kaq|kaq
kar|kar
kas|kas
kat|kat
kba|kba
kbb|kbb
kbc|kbc
kbd|kbd
kbe|kbe
kbf|kbf
kbg|kbg
kbh|kbh
kbi|kbi
kbj|kbj
kbk|kbk
kbl|kbl
kbm|kbm
kbn|kbn
kbo|kbo
kbp|kbp
kbq|kbq
kbr|kbr
kbs|kbs
kbt|kbt
kca|kca
kcb|kcb
kcc|kcc
kcd|kcd
kce|kce
kcf|kcf
kcg|kcg
kch|kch
kci|kci
kcj|kcj
kck|kck
kcl|kcl
kcm|kcm
kcn|kcn
kco|kco
kcp|kcp
kcq|kcq
kcr|kcr
kcs|kcs
kct|kct
kda|kda
kdb|kdb
kdc|kdc
kdd|kdd
kde|kde
kdf|kdf
kdg|kdg
kdh|kdh
kdi|kdi
kdj|kdj
kdk|kdk
kdl|kdl
kdm|kdm
kdn|kdn
kdo|kdo
kdp|kdp
kdq|kdq
kdr|kdr
kds|kds
kdt|kdt
kea|kea
keb|keb
kec|kec
ked|ked
kee|kee
kef|kef
keg|keg
keh|keh
kei|kei
kej|kej
kek|kek
kel|kel
kem|kem
ken|ken
keo|keo
kep|kep
keq|keq
ker|ker
kes|kes
ket|ket
kfa|kfa
kfb|kfb
kfc|kfc
kfd|kfd
kfe|kfe
kff|kff
kfg|kfg
kfh|kfh
kfi|kfi
kfj|kfj
kfk|kfk
kfl|kfl
kfm|kfm
kfn|kfn
kfo|kfo
kfp|kfp
kfq|kfq
kfr|kfr
kfs|kfs
kft|kft
kga|kga
kgb|kgb
kgc|kgc
kgd|kgd
kge|kge
kgf|kgf
kgg|kgg
kgh|kgh
kgi|kgi
kgj|kgj
kgk|kgk
kgl|kgl
kgm|kgm
kgn|kgn
kgo|kgo
kgp|kgp
kgq|kgq
kgr|kgr
kgs|kgs
kgt|kgt
kha|kha
khb|khb
khc|khc
khd|khd
khe|khe
khf|khf
khg|khg
khh|khh
khi|khi
khj|khj
khk|khk
khl|khl
khm|khm
khn|khn
kho|kho
khp|khp
khq|khq
khr|khr
khs|khs
kht|kht
kia|kia
kib|kib
kic|kic
kid|kid
kie|kie
kif|kif
kig|kig
kih|kih
kii|kii
kij|kij
kik|kik
kil|kil
kim|kim
kin|kin
kio|kio
kip|kip
kiq|kiq
kir|kir
kis|kis
kit|kit
kja|kja
kjb|kjb
kjc|kjc
kjd|kjd
kje|kje
kjf|kjf
kjg|kjg
kjh|kjh
kji|kji
kjj|kjj
kjk|kjk
kjl|kjl
kjm|kjm
kjn|kjn
kjo|kjo
kjp|kjp
kjq|kjq
kjr|kjr
kjs|kjs
kjt|kjt
kka|kka
kkb|kkb
kkc|kkc
kkd|kkd
kke|kke
kkf|kkf
kkg|kkg
kkh|kkh
kki|kki
kkj|kkj
kkk|kkk
kkl|kkl
kkm|kkm
kkn|kkn
kko|kko
kkp|kkp
kkq|kkq
kkr|kkr
kks|kks
kkt|kkt
kla|kla
klb|klb
klc|klc
kld|kld
kle|kle
klf|klf
klg|klg
klh|klh
kli|kli
klj|klj
klk|klk
kll|kll
klm|klm
kln|kln
klo|klo
klp|klp
klq|klq
klr|klr
kls|kls
klt|klt
kma|kma
kmb|kmb
kmc|kmc
kmd|kmd
kme|kme
kmf|kmf
kmg|kmg
kmh|kmh
kmi|kmi
kmj|kmj
kmk|kmk
kml|kml
kmm|kmm
kmn|kmn
kmo|kmo
kmp|kmp
kmq|kmq
kmr|kmr
kms|kms
kmt|kmt
kna|kna
knb|knb
knc|knc
knd|knd
kne|kne
knf|knf
kng|kng
knh|knh
kni|kni
knj|knj
knk|knk
knl|knl
knm|knm
knn|knn
kno|kno
knp|knp
knq|knq
knr|knr
kns|kns
knt|knt
koa|koa
kob|kob
koc|koc
kod|kod
koe|koe
kof|kof
kog|kog
koh|koh
koi|koi
koj|koj
kok|kok
kol|kol
kom|kom
kon|kon
koo|koo
kop|kop
koq|koq
kor|kor
kos|kos
kot|kot
kpa|kpa
kpb|kpb
kpc|kpc
kpd|kpd
kpe|kpe
kpf|kpf
kpg|kpg
kph|kph
kpi|kpi
kpj|kpj
kpk|kpk
kpl|kpl
kpm|kpm
kpn|kpn
kpo|kpo
kpp|kpp
kpq|kpq
kpr|kpr
kps|kps
kpt|kpt
kqa|kqa
kqb|kqb
kqc|kqc
kqd|kqd
kqe|kqe
kqf|kqf
kqg|kqg
kqh|kqh
kqi|kqi
kqj|kqj
kqk|kqk
kql|kql
kqm|kqm
kqn|kqn
kqo|kqo
kqp|kqp
kqq|kqq
kqr|kqr
kqs|kqs
kqt|kqt
kra|kra
krb|krb
krc|krc
krd|krd
kre|kre
krf|krf
krg|krg
krh|krh
kri|kri
krj|krj
krk|krk
krl|krl
krm|krm
krn|krn
kro|kro
krp|krp
krq|krq
krr|krr
krs|krs
krt|krt
ksa|ksa
ksb|ksb
ksc|ksc
ksd|ksd
kse|kse
ksf|ksf
ksg|ksg
ksh|ksh
ksi|ksi
ksj|ksj
ksk|ksk
ksl|ksl
ksm|ksm
ksn|ksn
kso|kso
ksp|ksp
ksq|ksq
ksr|ksr
kss|kss
kst|kst
kta|kta
ktb|ktb
ktc|ktc
ktd|ktd
kte|kte
ktf|ktf
ktg|ktg
kth|kth
kti|kti
ktj|ktj
ktk|ktk
ktl|ktl
ktm|ktm
ktn|ktn
kto|kto
ktp|ktp
ktq|ktq
ktr|ktr
kts|kts
ktt|ktt
laa|laa
lab|lab
lac|lac
lad|lad
lae|lae
laf|laf
lag|lag
lah|lah
lai|lai
laj|laj
lak|lak
lal|lal
lam|lam
lan|lan
lao|lao
lap|lap
laq|laq
lar|lar
las|las
lat|lat
lba|lba
lbb|lbb
lbc|lbc
lbd|lbd
lbe|lbe
lbf|lbf
lbg|lbg
lbh|lbh
lbi|lbi
lbj|lbj
lbk|lbk
lbl|lbl
lbm|lbm
lbn|lbn
lbo|lbo
lbp|lbp
lbq|lbq
lbr|lbr
lbs|lbs
lbt|lbt
lca|lca
lcb|lcb
lcc|lcc
lcd|lcd
lce|lce
lcf|lcf
lcg|lcg
lch|lch
lci|lci
lcj|lcj
lck|lck
lcl|lcl
lcm|lcm
lcn|lcn
lco|lco
lcp|lcp
lcq|lcq
lcr|lcr
lcs|lcs
lct|lct
lda|lda
ldb|ldb
ldc|ldc
ldd|ldd
lde|lde
ldf|ldf
ldg|ldg
ldh|ldh
ldi|ldi
ldj|ldj
ldk|ldk
ldl|ldl
ldm|ldm
ldn|ldn
ldo|ldo
ldp|ldp
ldq|ldq
ldr|ldr
lds|lds
ldt|ldt
lea|lea
leb|leb
lec|lec
led|led
lee|lee
lef|lef
leg|leg
leh|leh
lei|lei
lej|lej
lek|lek
lel|lel
lem|lem
len|len
leo|leo
lep|lep
leq|leq
ler|ler
les|les
let|let
lfa|lfa
lfb|lfb
lfc|lfc
lfd|lfd
lfe|lfe
lff|lff
lfg|lfg
lfh|lfh
lfi|lfi
lfj|lfj
lfk|lfk
lfl|lfl
lfm|lfm
lfn|lfn
lfo|lfo
lfp|lfp
lfq|lfq
lfr|lfr
lfs|lfs
lft|lft
lga|lga
lgb|lgb
lgc|lgc
lgd|lgd
lge|lge
lgf|lgf
lgg|lgg
lgh|lgh
lgi|lgi
lgj|lgj
lgk|lgk
lgl|lgl
lgm|lgm
lgn|lgn
lgo|lgo
lgp|lgp
lgq|lgq
lgr|lgr
lgs|lgs
lgt|lgt
lha|lha
lhb|lhb
lhc|lhc
lhd|lhd
lhe|lhe
lhf|lhf
lhg|lhg
lhh|lhh
lhi|lhi
lhj|lhj
lhk|lhk
lhl|lhl
lhm|lhm
lhn|lhn
lho|lho
lhp|lhp
lhq|lhq
lhr|lhr
lhs|lhs
lht|lht
lia|lia
lib|lib
lic|lic
lid|lid
lie|lie
lif|lif
lig|lig
lih|lih
lii|lii
lij|lij
lik|lik
lil|lil
lim|lim
lin|lin
lio|lio
lip|lip
liq|liq
lir|lir
lis|lis
lit|lit
lja|lja
ljb|ljb
ljc|ljc
ljd|ljd
lje|lje
ljf|ljf
ljg|ljg
ljh|ljh
lji|lji
ljj|ljj
ljk|ljk
ljl|ljl
ljm|ljm
ljn|ljn
ljo|ljo
ljp|ljp
ljq|ljq
ljr|ljr
ljs|ljs
ljt|ljt
lka|lka
lkb|lkb
lkc|lkc
lkd|lkd
lke|lke
lkf|lkf
lkg|lkg
lkh|lkh
lki|lki
lkj|lkj
lkk|lkk
lkl|lkl
lkm|lkm
lkn|lkn
lko|lko
lkp|lkp
lkq|lkq
lkr|lkr
lks|lks
lkt|lkt
lla|lla
llb|llb
llc|llc
lld|lld
lle|lle
llf|llf
llg|llg
llh|llh
lli|lli
llj|llj
llk|llk
lll|lll
llm|llm
lln|lln
llo|llo
llp|llp
llq|llq
llr|llr
lls|lls
llt|llt
lma|lma
lmb|lmb
lmc|lmc
lmd|lmd
lme|lme
lmf|lmf
lmg|lmg
lmh|lmh
lmi|lmi
lmj|lmj
lmk|lmk
lml|lml
lmm|lmm
lmn|lmn
lmo|lmo
lmp|lmp
lmq|lmq
lmr|lmr
lms|lms
lmt|lmt
lna|lna
lnb|lnb
lnc|lnc
lnd|lnd
lne|lne
lnf|lnf
lng|lng
lnh|lnh
lni|lni
lnj|lnj
lnk|lnk
lnl|lnl
lnm|lnm
lnn|lnn
lno|lno
lnp|lnp
lnq|lnq
lnr|lnr
lns|lns
lnt|lnt
loa|loa
lob|lob
loc|loc
lod|lod
loe|loe
lof|lof
log|log
loh|loh
loi|loi
loj|loj
lok|lok
lol|lol
lom|lom
lon|lon
loo|loo
lop|lop
loq|loq
lor|lor
los|los
lot|lot
lpa|lpa
lpb|lpb
lpc|lpc
lpd|lpd
lpe|lpe
lpf|lpf
lpg|lpg
lph|lph
lpi|lpi
lpj|lpj
lpk|lpk
lpl|lpl
lpm|lpm
lpn|lpn
lpo|lpo
lpp|lpp
lpq|lpq
lpr|lpr
lps|lps
lpt|lpt
lqa|lqa
lqb|lqb
lqc|lqc
lqd|lqd
lqe|lqe
lqf|lqf
lqg|lqg
lqh|lqh
lqi|lqi
lqj|lqj
lqk|lqk
lql|lql
lqm|lqm
lqn|lqn
lqo|lqo
lqp|lqp
lqq|lqq
lqr|lqr
lqs|lqs
lqt|lqt
lra|lra
lrb|lrb
lrc|lrc
lrd|lrd
lre|lre
lrf|lrf
lrg|lrg
lrh|lrh
lri|lri
lrj|lrj
lrk|lrk
lrl|lrl
lrm|lrm
lrn|lrn
lro|lro
lrp|lrp
lrq|lrq
lrr|lrr
lrs|lrs
lrt|lrt
lsa|lsa
lsb|lsb
lsc|lsc
lsd|lsd
lse|lse
lsf|lsf
lsg|lsg
lsh|lsh
lsi|lsi
lsj|lsj
lsk|lsk
lsl|lsl
lsm|lsm
lsn|lsn
lso|lso
lsp|lsp
lsq|lsq
lsr|lsr
lss|lss
lst|lst
lta|lta
ltb|ltb
ltc|ltc
ltd|ltd
lte|lte
ltf|ltf
ltg|ltg
lth|lth
lti|lti
ltj|ltj
ltk|ltk
ltl|ltl
ltm|ltm
ltn|ltn
lto|lto
ltp|ltp
ltq|ltq
ltr|ltr
lts|lts
ltt|ltt
maa|maa
mab|mab
mac|mac
mad|mad
mae|mae
maf|maf
mag|mag
mah|mah
mai|mai
maj|maj
mak|mak
mal|mal
mam|mam
man|man
mao|mao
map|map
maq|maq
mar|mar
mas|mas
mat|mat
mba|mba
mbb|mbb
mbc|mbc
mbd|mbd
mbe|mbe
mbf|mbf
mbg|mbg
mbh|mbh
mbi|mbi
mbj|mbj
mbk|mbk
mbl|mbl
mbm|mbm
mbn|mbn
mbo|mbo
mbp|mbp
mbq|mbq
mbr|mbr
mbs|mbs
mbt|mbt
mca|mca
mcb|mcb
mcc|mcc
mcd|mcd
mce|mce
mcf|mcf
mcg|mcg
mch|mch
mci|mci
mcj|mcj
mck|mck
mcl|mcl
mcm|mcm
mcn|mcn
mco|mco
mcp|mcp
mcq|mcq
mcr|mcr
mcs|mcs
mct|mct
mda|mda
mdb|mdb
mdc|mdc
mdd|mdd
mde|mde
mdf|mdf
mdg|mdg
mdh|mdh
mdi|mdi
mdj|mdj
mdk|mdk
mdl|mdl
mdm|mdm
mdn|mdn
mdo|mdo
mdp|mdp
mdq|mdq
mdr|mdr
mds|mds
mdt|mdt
mea|mea
meb|meb
mec|mec
med|med
mee|mee
mef|mef
meg|meg
meh|meh
mei|mei
mej|mej
mek|mek
mel|mel
mem|mem
men|men
meo|meo
mep|mep
meq|meq
mer|mer
mes|mes
met|met
mfa|mfa
mfb|mfb
mfc|mfc
mfd|mfd
mfe|mfe
mff|mff
mfg|mfg
mfh|mfh
mfi|mfi
mfj|mfj
mfk|mfk
mfl|mfl
mfm|mfm
mfn|mfn
mfo|mfo
mfp|mfp
mfq|mfq
mfr|mfr
mfs|mfs
mft|mft
mga|mga
mgb|mgb
mgc|mgc
mgd|mgd
mge|mge
mgf|mgf
mgg|mgg
mgh|mgh
mgi|mgi
mgj|mgj
mgk|mgk
mgl|mgl
mgm|mgm
mgn|mgn
mgo|mgo
mgp|mgp
mgq|mgq
mgr|mgr
mgs|mgs
mgt|mgt
mha|mha
mhb|mhb
mhc|mhc
mhd|mhd
mhe|mhe
mhf|mhf
mhg|mhg
mhh|mhh
mhi|mhi
mhj|mhj
mhk|mhk
mhl|mhl
mhm|mhm
mhn|mhn
mho|mho
mhp|mhp
mhq|mhq
mhr|mhr
mhs|mhs
mht|mht
mia|mia
mib|mib
mic|mic
mid|mid
mie|mie
mif|mif
mig|mig
mih|mih
mii|mii
mij|mij
mik|mik
mil|mil
mim|mim
min|min
mio|mio
mip|mip
miq|miq
mir|mir
mis|mis
mit|mit
mja|mja
mjb|mjb
mjc|mjc
mjd|mjd
mje|mje
mjf|mjf
mjg|mjg
mjh|mjh
mji|mji
mjj|mjj
mjk|mjk
mjl|mjl
mjm|mjm
mjn|mjn
mjo|mjo
mjp|mjp
mjq|mjq
mjr|mjr
mjs|mjs
mjt|mjt
mka|mka
mkb|mkb
mkc|mkc
mkd|mkd
mke|mke
mkf|mkf
mkg|mkg
mkh|mkh
mki|mki
mkj|mkj
mkk|mkk
mkl|mkl
mkm|mkm
mkn|mkn
mko|mko
mkp|mkp
mkq|mkq
mkr|mkr
mks|mks
mkt|mkt
mla|mla
mlb|mlb
mlc|mlc
mld|mld
mle|mle
mlf|mlf
mlg|mlg
mlh|mlh
mli|mli
mlj|mlj
mlk|mlk
mll|mll
mlm|mlm
mln|mln
mlo|mlo
mlp|mlp
mlq|mlq
mlr|mlr
mls|mls
mlt|mlt
mma|mma
mmb|mmb
mmc|mmc
mmd|mmd
mme|mme
mmf|mmf
mmg|mmg
mmh|mmh
mmi|mmi
mmj|mmj
mmk|mmk
mml|mml
mmm|mmm
mmn|mmn
mmo|mmo
mmp|mmp
mmq|mmq
mmr|mmr
mms|mms
mmt|mmt
mna|mna
mnb|mnb
mnc|mnc
mnd|mnd
mne|mne
mnf|mnf
mng|mng
mnh|mnh
mni|mni
mnj|mnj
mnk|mnk
mnl|mnl
mnm|mnm
mnn|mnn
mno|mno
mnp|mnp
mnq|mnq
mnr|mnr
mns|mns
mnt|mnt
moa|moa
mob|mob
moc|moc
mod|mod
moe|moe
mof|mof
mog|mog
moh|moh
moi|moi
moj|moj
mok|mok
mol|mol
mom|mom
mon|mon
moo|moo
mop|mop
moq|moq
mor|mor
mos|mos
mot|mot
mpa|mpa
mpb|mpb
mpc|mpc
mpd|mpd
mpe|mpe
mpf|mpf
mpg|mpg
mph|mph
mpi|mpi
mpj|mpj
mpk|mpk
mpl|mpl
mpm|mpm
mpn|mpn
mpo|mpo
mpp|mpp
mpq|mpq
mpr|mpr
mps|mps
mpt|mpt
mqa|mqa
mqb|mqb
mqc|mqc
mqd|mqd
mqe|mqe
mqf|mqf
mqg|mqg
mqh|mqh
mqi|mqi
mqj|mqj
mqk|mqk
mql|mql
mqm|mqm
mqn|mqn
mqo|mqo
mqp|mqp
mqq|mqq
mqr|mqr
mqs|mqs
mqt|mqt
mra|mra
mrb|mrb
mrc|mrc
mrd|mrd
mre|mre
mrf|mrf
mrg|mrg
mrh|mrh
mri|mri
mrj|mrj
mrk|mrk
mrl|mrl
mrm|mrm
mrn|mrn
mro|mro
mrp|mrp
mrq|mrq
mrr|mrr
mrs|mrs
mrt|mrt
msa|msa
msb|msb
msc|msc
msd|msd
mse|mse
msf|msf
msg|msg
msh|msh
msi|msi
msj|msj
msk|msk
msl|msl
msm|msm
msn|msn
mso|mso
msp|msp
msq|msq
msr|msr
mss|mss
mst|mst
mta|mta
mtb|mtb
mtc|mtc
mtd|mtd
mte|mte
mtf|mtf
mtg|mtg
mth|mth
mti|mti
mtj|mtj
mtk|mtk
mtl|mtl
mtm|mtm
mtn|mtn
mto|mto
mtp|mtp
mtq|mtq
mtr|mtr
mts|mts
mtt|mtt
naa|naa
nab|nab
nac|nac
nad|nad
nae|nae
naf|naf
nag|nag
nah|nah
nai|nai
naj|naj
nak|nak
nal|nal
nam|nam
nan|nan
nao|nao
nap|nap
naq|naq
nar|nar
nas|nas
nat|nat
nba|nba
nbb|nbb
nbc|nbc
nbd|nbd
nbe|nbe
nbf|nbf
nbg|nbg
nbh|nbh
nbi|nbi
nbj|nbj
nbk|nbk
nbl|nbl
nbm|nbm
nbn|nbn
nbo|nbo
nbp|nbp
nbq|nbq
nbr|nbr
nbs|nbs
nbt|nbt
nca|nca
ncb|ncb
ncc|ncc
ncd|ncd
nce|nce
ncf|ncf
ncg|ncg
nch|nch
nci|nci
ncj|ncj
nck|nck
ncl|ncl
ncm|ncm
ncn|ncn
nco|nco
ncp|ncp
ncq|ncq
ncr|ncr
ncs|ncs
nct|nct
nda|nda
ndb|ndb
ndc|ndc
ndd|ndd
nde|nde
ndf|ndf
ndg|ndg
ndh|ndh
ndi|ndi
ndj|ndj
ndk|ndk
ndl|ndl
ndm|ndm
ndn|ndn
ndo|ndo
ndp|ndp
ndq|ndq
ndr|ndr
nds|nds
ndt|ndt
nea|nea
neb|neb
nec|nec
ned|ned
nee|nee
nef|nef
neg|neg
neh|neh
nei|nei
nej|nej
nek|nek
nel|nel
nem|nem
nen|nen
neo|neo
nep|nep
neq|neq
ner|ner
nes|nes
net|net
nfa|nfa
nfb|nfb
nfc|nfc
nfd|nfd
nfe|nfe
nff|nff
nfg|nfg
nfh|nfh
nfi|nfi
nfj|nfj
nfk|nfk
nfl|nfl
nfm|nfm
nfn|nfn
nfo|nfo
nfp|nfp
nfq|nfq
nfr|nfr
nfs|nfs
nft|nft
nga|nga
ngb|ngb
ngc|ngc
ngd|ngd
nge|nge
ngf|ngf
ngg|ngg
ngh|ngh
ngi|ngi
ngj|ngj
ngk|ngk
ngl|ngl
ngm|ngm
ngn|ngn
ngo|ngo
ngp|ngp
ngq|ngq
ngr|ngr
ngs|ngs
ngt|ngt
nha|nha
nhb|nhb
nhc|nhc
nhd|nhd
nhe|nhe
nhf|nhf
nhg|nhg
nhh|nhh
nhi|nhi
nhj|nhj
nhk|nhk
nhl|nhl
nhm|nhm
nhn|nhn
nho|nho
nhp|nhp
nhq|nhq
nhr|nhr
nhs|nhs
nht|nht
nia|nia
nib|nib
nic|nic
nid|nid
nie|nie
nif|nif
nig|nig
nih|nih
nii|nii
nij|nij
nik|nik
nil|nil
nim|nim
nin|nin
nio|nio
nip|nip
niq|niq
nir|nir
nis|nis
nit|nit
nja|nja
njb|njb
njc|njc
njd|njd
nje|nje
njf|njf
njg|njg
njh|njh
nji|nji
njj|njj
njk|njk
njl|njl
njm|njm
njn|njn
njo|njo
njp|njp
njq|njq
njr|njr
njs|njs
njt|njt
nka|nka
nkb|nkb
nkc|nkc
nkd|nkd
nke|nke
nkf|nkf
nkg|nkg
nkh|nkh
nki|nki
nkj|nkj
nkk|nkk
nkl|nkl
nkm|nkm
nkn|nkn
nko|nko
nkp|nkp
nkq|nkq
nkr|nkr
nks|nks
nkt|nkt
nla|nla
nlb|nlb
nlc|nlc
nld|nld
nle|nle
nlf|nlf
nlg|nlg
nlh|nlh
nli|nli
nlj|nlj
nlk|nlk
nll|nll
nlm|nlm
nln|nln
nlo|nlo
nlp|nlp
nlq|nlq
nlr|nlr
nls|nls
nlt|nlt
nma|nma
nmb|nmb
nmc|nmc
nmd|nmd
nme|nme
nmf|nmf
nmg|nmg
nmh|nmh
nmi|nmi
nmj|nmj
nmk|nmk
nml|nml
nmm|nmm
nmn|nmn
nmo|nmo
nmp|nmp
nmq|nmq
nmr|nmr
nms|nms
nmt|nmt
nna|nna
nnb|nnb
nnc|nnc
nnd|nnd
nne|nne
nnf|nnf
nng|nng
nnh|nnh
nni|nni
nnj|nnj
nnk|nnk
nnl|nnl
nnm|nnm
nnn|nnn
nno|nno
nnp|nnp
nnq|nnq
nnr|nnr
nns|nns
nnt|nnt
noa|noa
nob|nob
noc|noc
nod|nod
noe|noe
nof|nof
nog|nog
noh|noh
noi|noi
noj|noj
nok|nok
nol|nol
nom|nom
non|non
noo|noo
nop|nop
noq|noq
nor|nor
nos|nos
not|not
npa|npa
npb|npb
npc|npc
npd|npd
npe|npe
npf|npf
npg|npg
nph|nph
npi|npi
npj|npj
npk|npk
npl|npl
npm|npm
npn|npn
npo|npo
npp|npp
npq|npq
npr|npr
nps|nps
npt|npt
nqa|nqa
nqb|nqb
nqc|nqc
nqd|nqd
nqe|nqe
nqf|nqf
nqg|nqg
nqh|nqh
nqi|nqi
nqj|nqj
nqk|nqk
nql|nql
nqm|nqm
nqn|nqn
nqo|nqo
nqp|nqp
nqq|nqq
nqr|nqr
nqs|nqs
nqt|nqt
nra|nra
nrb|nrb
nrc|nrc
nrd|nrd
nre|nre
nrf|nrf
nrg|nrg
nrh|nrh
nri|nri
nrj|nrj
nrk|nrk
nrl|nrl
nrm|nrm
nrn|nrn
nro|nro
nrp|nrp
nrq|nrq
nrr|nrr
nrs|nrs
nrt|nrt
nsa|nsa
nsb|nsb
nsc|nsc
nsd|nsd
nse|nse
nsf|nsf
nsg|nsg
nsh|nsh
nsi|nsi
nsj|nsj
nsk|nsk
nsl|nsl
nsm|nsm
nsn|nsn
nso|nso
nsp|nsp
nsq|nsq
nsr|nsr
nss|nss
nst|nst
nta|nta
ntb|ntb
ntc|ntc
ntd|ntd
nte|nte
ntf|ntf
ntg|ntg
nth|nth
nti|nti
ntj|ntj
ntk|ntk
ntl|ntl
ntm|ntm
ntn|ntn
nto|nto
ntp|ntp
ntq|ntq
ntr|ntr
nts|nts
ntt|ntt
oaa|oaa
oab|oab
oac|oac
oad|oad
oae|oae
oaf|oaf
oag|oag
oah|oah
oai|oai
oaj|oaj
oak|oak
oal|oal
oam|oam
oan|oan
oao|oao
oap|oap
oaq|oaq
oar|oar
oas|oas
oat|oat
oba|oba
obb|obb
obc|obc
obd|obd
obe|obe
obf|obf
obg|obg
obh|obh
obi|obi
obj|obj
obk|obk
obl|obl
obm|obm
obn|obn
obo|obo
obp|obp
obq|obq
obr|obr
obs|obs
obt|obt
oca|oca
ocb|ocb
occ|occ
ocd|ocd
oce|oce
ocf|ocf
ocg|ocg
och|och
oci|oci
ocj|ocj
ock|ock
ocl|ocl
ocm|ocm
ocn|ocn
oco|oco
ocp|ocp
ocq|ocq
ocr|ocr
ocs|ocs
oct|oct
oda|oda
odb|odb
odc|odc
odd|odd
ode|ode
odf|odf
odg|odg
odh|odh
odi|odi
odj|odj
odk|odk
odl|odl
odm|odm
odn|odn
odo|odo
odp|odp
odq|odq
odr|odr
ods|ods
odt|odt
oea|oea
oeb|oeb
oec|oec
oed|oed
oee|oee
oef|oef
oeg|oeg
oeh|oeh
oei|oei
oej|oej
oek|oek
oel|oel
oem|oem
oen|oen
oeo|oeo
oep|oep
oeq|oeq
oer|oer
oes|oes
oet|oet
ofa|ofa
ofb|ofb
ofc|ofc
ofd|ofd
ofe|ofe
off|off
ofg|ofg
ofh|ofh
ofi|ofi
ofj|ofj
ofk|ofk
ofl|ofl
ofm|ofm
ofn|ofn
ofo|ofo
ofp|ofp
ofq|ofq
ofr|ofr
ofs|ofs
oft|oft
oga|oga
ogb|ogb
ogc|ogc
ogd|ogd
oge|oge
ogf|ogf
ogg|ogg
ogh|ogh
ogi|ogi
ogj|ogj
ogk|ogk
ogl|ogl
ogm|ogm
ogn|ogn
ogo|ogo
ogp|ogp
ogq|ogq
ogr|ogr
ogs|ogs
ogt|ogt
oha|oha
ohb|ohb
ohc|ohc
ohd|ohd
ohe|ohe
ohf|ohf
ohg|ohg
ohh|ohh
ohi|ohi
ohj|ohj
ohk|ohk
ohl|ohl
ohm|ohm
ohn|ohn
oho|oho
ohp|ohp
ohq|ohq
ohr|ohr
ohs|ohs
oht|oht
oia|oia
oib|oib
oic|oic
oid|oid
oie|oie
oif|oif
oig|oig
oih|oih
oii|oii
oij|oij
oik|oik
oil|oil
oim|oim
oin|oin
oio|oio
oip|oip
oiq|oiq
oir|oir
ois|ois
oit|oit
oja|oja
ojb|ojb
ojc|ojc
ojd|ojd
oje|oje
ojf|ojf
ojg|ojg
ojh|ojh
oji|oji
ojj|ojj
ojk|ojk
ojl|ojl
ojm|ojm
ojn|ojn
ojo|ojo
ojp|ojp
ojq|ojq
ojr|ojr
ojs|ojs
ojt|ojt
oka|oka
okb|okb
okc|okc
okd|okd
oke|oke
okf|okf
okg|okg
okh|okh
oki|oki
okj|okj
okk|okk
okl|okl
okm|okm
okn|okn
oko|oko
okp|okp
okq|okq
okr|okr
oks|oks
okt|okt
ola|ola
olb|olb
olc|olc
old|old
ole|ole
olf|olf
olg|olg
olh|olh
oli|oli
olj|olj
olk|olk
oll|oll
olm|olm
oln|oln
olo|olo
olp|olp
olq|olq
olr|olr
ols|ols
olt|olt
oma|oma
omb|omb
omc|omc
omd|omd
ome|ome
omf|omf
omg|omg
omh|omh
omi|omi
omj|omj
omk|omk
oml|oml
omm|omm
omn|omn
omo|omo
omp|omp
omq|omq
omr|omr
oms|oms
omt|omt
ona|ona
onb|onb
onc|onc
ond|ond
one|one
onf|onf
ong|ong
onh|onh
oni|oni
onj|onj
onk|onk
onl|onl
onm|onm
onn|onn
ono|ono
onp|onp
onq|onq
onr|onr
ons|ons
ont|ont
ooa|ooa
oob|oob
ooc|ooc
ood|ood
ooe|ooe
oof|oof
oog|oog
ooh|ooh
ooi|ooi
ooj|ooj
ook|ook
ool|ool
oom|oom
oon|oon
ooo|ooo
oop|oop
ooq|ooq
oor|oor
oos|oos
oot|oot
opa|opa
opb|opb
opc|opc
opd|opd
ope|ope
opf|opf
opg|opg
oph|oph
opi|opi
opj|opj
opk|opk
opl|opl
opm|opm
opn|opn
opo|opo
opp|opp
opq|opq
opr|opr
ops|ops
opt|opt
oqa|oqa
oqb|oqb
oqc|oqc
oqd|oqd
oqe|oqe
oqf|oqf
oqg|oqg
oqh|oqh
oqi|oqi
oqj|oqj
oqk|oqk
oql|oql
oqm|oqm
oqn|oqn
oqo|oqo
oqp|oqp
oqq|oqq
oqr|oqr
oqs|oqs
oqt|oqt
ora|ora
orb|orb
orc|orc
ord|ord
ore|ore
orf|orf
org|org
orh|orh
ori|ori
orj|orj
ork|ork
orl|orl
orm|orm
orn|orn
oro|oro
orp|orp
orq|orq
orr|orr
ors|ors
ort|ort
osa|osa
osb|osb
osc|osc
osd|osd
ose|ose
osf|osf
osg|osg
osh|osh
osi|osi
osj|osj
osk|osk
osl|osl
osm|osm
osn|osn
oso|oso
osp|osp
osq|osq
osr|osr
oss|oss
ost|ost
ota|ota
otb|otb
otc|otc
otd|otd
ote|ote
otf|otf
otg|otg
oth|oth
oti|oti
otj|otj
otk|otk
otl|otl
otm|otm
otn|otn
oto|oto
otp|otp
otq|otq
otr|otr
ots|ots
ott|ott
paa|paa
pab|pab
pac|pac
pad|pad
pae|pae
paf|paf
pag|pag
pah|pah
pai|pai
paj|paj
pak|pak
pal|pal
pam|pam
pan|pan
pao|pao
pap|pap
paq|paq
par|par
pas|pas
pat|pat
pba|pba
pbb|pbb
pbc|pbc
pbd|pbd
pbe|pbe
pbf|pbf
pbg|pbg
pbh|pbh
pbi|pbi
pbj|pbj
pbk|pbk
pbl|pbl
pbm|pbm
pbn|pbn
pbo|pbo
pbp|pbp
pbq|pbq
pbr|pbr
pbs|pbs
pbt|pbt
pca|pca
pcb|pcb
pcc|pcc
pcd|pcd
pce|pce
pcf|pcf
pcg|pcg
pch|pch
pci|pci
pcj|pcj
pck|pck
pcl|pcl
pcm|pcm
pcn|pcn
pco|pco
pcp|pcp
pcq|pcq
pcr|pcr
pcs|pcs
pct|pct
pda|pda
pdb|pdb
pdc|pdc
pdd|pdd
pde|pde
pdf|pdf
pdg|pdg
pdh|pdh
pdi|pdi
pdj|pdj
pdk|pdk
pdl|pdl
pdm|pdm
pdn|pdn
pdo|pdo
pdp|pdp
pdq|pdq
pdr|pdr
pds|pds
pdt|pdt
pea|pea
peb|peb
pec|pec
ped|ped
pee|pee
pef|pef
peg|peg
peh|peh
pei|pei
pej|pej
pek|pek
pel|pel
pem|pem
pen|pen
peo|peo
pep|pep
peq|peq
per|per
pes|pes
pet|pet
pfa|pfa
pfb|pfb
pfc|pfc
pfd|pfd
pfe|pfe
pff|pff
pfg|pfg
pfh|pfh
pfi|pfi
pfj|pfj
pfk|pfk
pfl|pfl
pfm|pfm
pfn|pfn
pfo|pfo
pfp|pfp
pfq|pfq
pfr|pfr
pfs|pfs
pft|pft
pga|pga
pgb|pgb
pgc|pgc
pgd|pgd
pge|pge
pgf|pgf
pgg|pgg
pgh|pgh
pgi|pgi
pgj|pgj
pgk|pgk
pgl|pgl
pgm|pgm
pgn|pgn
pgo|pgo
pgp|pgp
pgq|pgq
pgr|pgr
pgs|pgs
pgt|pgt
pha|pha
phb|phb
phc|phc
phd|phd
phe|phe
phf|phf
phg|phg
phh|phh
phi|phi
phj|phj
phk|phk
phl|phl
phm|phm
phn|phn
pho|pho
php|php
phq|phq
phr|phr
phs|phs
pht|pht
pia|pia
pib|pib
pic|pic
pid|pid
pie|pie
pif|pif
pig|pig
pih|pih
pii|pii
pij|pij
pik|pik
pil|pil
pim|pim
pin|pin
pio|pio
pip|pip
piq|piq
pir|pir
pis|pis
pit|pit
pja|pja
pjb|pjb
pjc|pjc
pjd|pjd
pje|pje
pjf|pjf
pjg|pjg
pjh|pjh
pji|pji
pjj|pjj
pjk|pjk
pjl|pjl
pjm|pjm
pjn|pjn
pjo|pjo
pjp|pjp
pjq|pjq
pjr|pjr
pjs|pjs
pjt|pjt
pka|pka
pkb|pkb
pkc|pkc
pkd|pkd
pke|pke
pkf|pkf
pkg|pkg
pkh|pkh
pki|pki
pkj|pkj
pkk|pkk
pkl|pkl
pkm|pkm
pkn|pkn
pko|pko
pkp|pkp
pkq|pkq
pkr|pkr
pks|pks
pkt|pkt
pla|pla
plb|plb
plc|plc
pld|pld
ple|ple
plf|plf
plg|plg
plh|plh
pli|pli
plj|plj
plk|plk
pll|pll
plm|plm
pln|pln
plo|plo
plp|plp
plq|plq
plr|plr
pls|pls
plt|plt
pma|pma
pmb|pmb
pmc|pmc
pmd|pmd
pme|pme
pmf|pmf
pmg|pmg
pmh|pmh
pmi|pmi
pmj|pmj
pmk|pmk
pml|pml
pmm|pmm
pmn|pmn
pmo|pmo
pmp|pmp
pmq|pmq
pmr|pmr
pms|pms
pmt|pmt
pna|pna
pnb|pnb
pnc|pnc
pnd|pnd
pne|pne
pnf|pnf
png|png
pnh|pnh
pni|pni
pnj|pnj
pnk|pnk
pnl|pnl
pnm|pnm
pnn|pnn
pno|pno
pnp|pnp
pnq|pnq
pnr|pnr
pns|pns
pnt|pnt
poa|poa
pob|pob
poc|poc
pod|pod
poe|poe
pof|pof
pog|pog
poh|poh
poi|poi
poj|poj
pok|pok
pol|pol
pom|pom
pon|pon
poo|poo
pop|pop
poq|poq
por|por
pos|pos
pot|pot
ppa|ppa
ppb|ppb
ppc|ppc
ppd|ppd
ppe|ppe
ppf|ppf
ppg|ppg
pph|pph
ppi|ppi
ppj|ppj
ppk|ppk
ppl|ppl
ppm|ppm
ppn|ppn
ppo|ppo
ppp|ppp
ppq|ppq
ppr|ppr
pps|pps
ppt|ppt
pqa|pqa
pqb|pqb
pqc|pqc
pqd|pqd
pqe|pqe
pqf|pqf
pqg|pqg
pqh|pqh
pqi|pqi
pqj|pqj
pqk|pqk
pql|pql
pqm|pqm
pqn|pqn
pqo|pqo
pqp|pqp
pqq|pqq
pqr|pqr
pqs|pqs
pqt|pqt
pra|pra
prb|prb
prc|prc
prd|prd
pre|pre
prf|prf
prg|prg
prh|prh
pri|pri
prj|prj
prk|prk
prl|prl
prm|prm
prn|prn
pro|pro
prp|prp
prq|prq
prr|prr
prs|prs
prt|prt
psa|psa
psb|psb
psc|psc
psd|psd
pse|pse
psf|psf
psg|psg
psh|psh
psi|psi
psj|psj
psk|psk
psl|psl
psm|psm
psn|psn
pso|pso
psp|psp
psq|psq
psr|psr
pss|pss
pst|pst
pta|pta
ptb|ptb
ptc|ptc
ptd|ptd
pte|pte
ptf|ptf
ptg|ptg
pth|pth
pti|pti
ptj|ptj
ptk|ptk
ptl|ptl
ptm|ptm
ptn|ptn
pto|pto
ptp|ptp
ptq|ptq
ptr|ptr
pts|pts
ptt|ptt
qaa|qaa
qab|qab
qac|qac
qad|qad
qae|qae
qaf|qaf
qag|qag
qah|qah
qai|qai
qaj|qaj
qak|qak
qal|qal
qam|qam
qan|qan
qao|qao
qap|qap
qaq|qaq
qar|qar
qas|qas
qat|qat
qba|qba
qbb|qbb
qbc|qbc
qbd|qbd
qbe|qbe
qbf|qbf
qbg|qbg
qbh|qbh
qbi|qbi
qbj|qbj
qbk|qbk
qbl|qbl
qbm|qbm
qbn|qbn
qbo|qbo
qbp|qbp
qbq|qbq
qbr|qbr
qbs|qbs
qbt|qbt
qca|qca
qcb|qcb
qcc|qcc
qcd|qcd
qce|qce
qcf|qcf
qcg|qcg
qch|qch
qci|qci
qcj|qcj
qck|qck
qcl|qcl
qcm|qcm
qcn|qcn
qco|qco
qcp|qcp
qcq|qcq
qcr|qcr
qcs|qcs
qct|qct
qda|qda
qdb|qdb
qdc|qdc
qdd|qdd
qde|qde
qdf|qdf
qdg|qdg
qdh|qdh
qdi|qdi
qdj|qdj
qdk|qdk
qdl|qdl
qdm|qdm
qdn|qdn
qdo|qdo
qdp|qdp
qdq|qdq
qdr|qdr
qds|qds
qdt|qdt
qea|qea
qeb|qeb
qec|qec
qed|qed
qee|qee
qef|qef
qeg|qeg
qeh|qeh
qei|qei
qej|qej
qek|qek
qel|qel
qem|qem
qen|qen
qeo|qeo
qep|qep
qeq|qeq
qer|qer
qes|qes
qet|qet
qfa|qfa
qfb|qfb
qfc|qfc
qfd|qfd
qfe|qfe
qff|qff
qfg|qfg
qfh|qfh
qfi|qfi
qfj|qfj
qfk|qfk
qfl|qfl
qfm|qfm
qfn|qfn
qfo|qfo
qfp|qfp
qfq|qfq
qfr|qfr
qfs|qfs
qft|qft
qga|qga
qgb|qgb
qgc|qgc
qgd|qgd
qge|qge
qgf|qgf
qgg|qgg
qgh|qgh
qgi|qgi
qgj|qgj
qgk|qgk
qgl|qgl
qgm|qgm
qgn|qgn
qgo|qgo
qgp|qgp
qgq|qgq
qgr|qgr
qgs|qgs
qgt|qgt
qha|qha
qhb|qhb
qhc|qhc
qhd|qhd
qhe|qhe
qhf|qhf
qhg|qhg
qhh|qhh
qhi|qhi
qhj|qhj
qhk|qhk
qhl|qhl
qhm|qhm
qhn|qhn
qho|qho
qhp|qhp
qhq|qhq
qhr|qhr
qhs|qhs
qht|qht
qia|qia
qib|qib
qic|qic
qid|qid
qie|qie
qif|qif
qig|qig
qih|qih
qii|qii
qij|qij
qik|qik
qil|qil
qim|qim
qin|qin
qio|qio
qip|qip
qiq|qiq
qir|qir
qis|qis
qit|qit
qja|qja
qjb|qjb
qjc|qjc
qjd|qjd
qje|qje
qjf|qjf
qjg|qjg
qjh|qjh
qji|qji
qjj|qjj
qjk|qjk
qjl|qjl
qjm|qjm
qjn|qjn
qjo|qjo
qjp|qjp
qjq|qjq
qjr|qjr
qjs|qjs
qjt|qjt
qka|qka
qkb|qkb
qkc|qkc
qkd|qkd
qke|qke
qkf|qkf
qkg|qkg
qkh|qkh
qki|qki
qkj|qkj
qkk|qkk
qkl|qkl
qkm|qkm
qkn|qkn
qko|qko
qkp|qkp
qkq|qkq
qkr|qkr
qks|qks
qkt|qkt
qla|qla
qlb|qlb
qlc|qlc
qld|qld
qle|qle
qlf|qlf
qlg|qlg
qlh|qlh
qli|qli
qlj|qlj
qlk|qlk
qll|qll
qlm|qlm
qln|qln
qlo|qlo
qlp|qlp
qlq|qlq
qlr|qlr
qls|qls
qlt|qlt
qma|qma
qmb|qmb
qmc|qmc
qmd|qmd
qme|qme
qmf|qmf
qmg|qmg
qmh|qmh
qmi|qmi
qmj|qmj
qmk|qmk
qml|qml
qmm|qmm
qmn|qmn
qmo|qmo
qmp|qmp
qmq|qmq
qmr|qmr
qms|qms
qmt|qmt
qna|qna
qnb|qnb
qnc|qnc
qnd|qnd
qne|qne
qnf|qnf
qng|qng
qnh|qnh
qni|qni
qnj|qnj
qnk|qnk
qnl|qnl
qnm|qnm
qnn|qnn
qno|qno
qnp|qnp
qnq|qnq
qnr|qnr
qns|qns
qnt|qnt
qoa|qoa
qob|qob
qoc|qoc
qod|qod
qoe|qoe
qof|qof
qog|qog
qoh|qoh
qoi|qoi
qoj|qoj
qok|qok
qol|qol
qom|qom
qon|qon
qoo|qoo
qop|qop
qoq|qoq
qor|qor
qos|qos
qot|qot
qpa|qpa
qpb|qpb
qpc|qpc
qpd|qpd
qpe|qpe
qpf|qpf
qpg|qpg
qph|qph
qpi|qpi
qpj|qpj
qpk|qpk
qpl|qpl
qpm|qpm
qpn|qpn
qpo|qpo
qpp|qpp
qpq|qpq
qpr|qpr
qps|qps
qpt|qpt
qqa|qqa
qqb|qqb
qqc|qqc
qqd|qqd
qqe|qqe
qqf|qqf
qqg|qqg
qqh|qqh
qqi|qqi
qqj|qqj
qqk|qqk
qql|qql
qqm|qqm
qqn|qqn
qqo|qqo
qqp|qqp
qqq|qqq
qqr|qqr
qqs|qqs
qqt|qqt
qra|qra
qrb|qrb
qrc|qrc
qrd|qrd
qre|qre
qrf|qrf
qrg|qrg
qrh|qrh
qri|qri
qrj|qrj
qrk|qrk
qrl|qrl
qrm|qrm
qrn|qrn
qro|qro
qrp|qrp
qrq|qrq
qrr|qrr
qrs|qrs
qrt|qrt
qsa|qsa
qsb|qsb
qsc|qsc
qsd|qsd
qse|qse
qsf|qsf
qsg|qsg
qsh|qsh
qsi|qsi
qsj|qsj
qsk|qsk
qsl|qsl
qsm|qsm
qsn|qsn
qso|qso
qsp|qsp
qsq|qsq
qsr|qsr
qss|qss
qst|qst
qta|qta
qtb|qtb
qtc|qtc
qtd|qtd
qte|qte
qtf|qtf
qtg|qtg
qth|qth
qti|qti
qtj|qtj
qtk|qtk
qtl|qtl
qtm|qtm
qtn|qtn
qto|qto
qtp|qtp
qtq|qtq
qtr|qtr
qts|qts
qtt|qtt
raa|raa
rab|rab
rac|rac
rad|rad
rae|rae
raf|raf
rag|rag
rah|rah
rai|rai
raj|raj
rak|rak
ral|ral
ram|ram
ran|ran
rao|rao
rap|rap
raq|raq
rar|rar
ras|ras
rat|rat
rba|rba
rbb|rbb
rbc|rbc
rbd|rbd
rbe|rbe
rbf|rbf
rbg|rbg
rbh|rbh
rbi|rbi
rbj|rbj
rbk|rbk
rbl|rbl
rbm|rbm
rbn|rbn
rbo|rbo
rbp|rbp
rbq|rbq
rbr|rbr
rbs|rbs
rbt|rbt
rca|rca
rcb|rcb
rcc|rcc
rcd|rcd
rce|rce
rcf|rcf
rcg|rcg
rch|rch
rci|rci
rcj|rcj
rck|rck
rcl|rcl
rcm|rcm
rcn|rcn
rco|rco
rcp|rcp
rcq|rcq
rcr|rcr
rcs|rcs
rct|rct
rda|rda
rdb|rdb
rdc|rdc
rdd|rdd
rde|rde
rdf|rdf
rdg|rdg
rdh|rdh
rdi|rdi
rdj|rdj
rdk|rdk
rdl|rdl
rdm|rdm
rdn|rdn
rdo|rdo
rdp|rdp
rdq|rdq
rdr|rdr
rds|rds
rdt|rdt
rea|rea
reb|reb
rec|rec
red|red
ree|ree
ref|ref
reg|reg
reh|reh
rei|rei
rej|rej
rek|rek
rel|rel
rem|rem
ren|ren
reo|reo
rep|rep
req|req
rer|rer
res|res
ret|ret
rfa|rfa
rfb|rfb
rfc|rfc
rfd|rfd
rfe|rfe
rff|rff
rfg|rfg
rfh|rfh
rfi|rfi
rfj|rfj
rfk|rfk
rfl|rfl
rfm|rfm
rfn|rfn
rfo|rfo
rfp|rfp
rfq|rfq
rfr|rfr
rfs|rfs
rft|rft
rga|rga
rgb|rgb
rgc|rgc
rgd|rgd
rge|rge
rgf|rgf
rgg|rgg
rgh|rgh
rgi|rgi
rgj|rgj
rgk|rgk
rgl|rgl
rgm|rgm
rgn|rgn
rgo|rgo
rgp|rgp
rgq|rgq
rgr|rgr
rgs|rgs
rgt|rgt
rha|rha
rhb|rhb
rhc|rhc
rhd|rhd
rhe|rhe
rhf|rhf
rhg|rhg
rhh|rhh
rhi|rhi
rhj|rhj
rhk|rhk
rhl|rhl
rhm|rhm
rhn|rhn
rho|rho
rhp|rhp
rhq|rhq
rhr|rhr
rhs|rhs
rht|rht
ria|ria
rib|rib
ric|ric
rid|rid
rie|rie
rif|rif
rig|rig
rih|rih
rii|rii
rij|rij
rik|rik
ril|ril
rim|rim
rin|rin
rio|rio
rip|rip
riq|riq
rir|rir
ris|ris
rit|rit
rja|rja
rjb|rjb
rjc|rjc
rjd|rjd
rje|rje
rjf|rjf
rjg|rjg
rjh|rjh
rji|rji
rjj|rjj
rjk|rjk
rjl|rjl
rjm|rjm
rjn|rjn
rjo|rjo
rjp|rjp
rjq|rjq
rjr|rjr
rjs|rjs
rjt|rjt
rka|rka
rkb|rkb
rkc|rkc
rkd|rkd
rke|rke
rkf|rkf
rkg|rkg
rkh|rkh
rki|rki
rkj|rkj
rkk|rkk
rkl|rkl
rkm|rkm
rkn|rkn
rko|rko
rkp|rkp
rkq|rkq
rkr|rkr
rks|rks
rkt|rkt
rla|rla
rlb|rlb
rlc|rlc
rld|rld
rle|rle
rlf|rlf
rlg|rlg
rlh|rlh
rli|rli
rlj|rlj
rlk|rlk
rll|rll
rlm|rlm
rln|rln
rlo|rlo
rlp|rlp
rlq|rlq
rlr|rlr
rls|rls
rlt|rlt
rma|rma
rmb|rmb
rmc|rmc
rmd|rmd
rme|rme
rmf|rmf
rmg|rmg
rmh|rmh
rmi|rmi
rmj|rmj
rmk|rmk
rml|rml
rmm|rmm
rmn|rmn
rmo|rmo
rmp|rmp
rmq|rmq
rmr|rmr
rms|rms
rmt|rmt
rna|rna
rnb|rnb
rnc|rnc
rnd|rnd
rne|rne
rnf|rnf
rng|rng
rnh|rnh
rni|rni
rnj|rnj
rnk|rnk
rnl|rnl
rnm|rnm
rnn|rnn
rno|rno
rnp|rnp
rnq|rnq
rnr|rnr
rns|rns
rnt|rnt
roa|roa
rob|rob
roc|roc
rod|rod
roe|roe
rof|rof
rog|rog
roh|roh
roi|roi
roj|roj
rok|rok
rol|rol
rom|rom
ron|ron
roo|roo
rop|rop
roq|roq
ror|ror
ros|ros
rot|rot
rpa|rpa
rpb|rpb
rpc|rpc
rpd|rpd
rpe|rpe
rpf|rpf
rpg|rpg
rph|rph
rpi|rpi
rpj|rpj
rpk|rpk
rpl|rpl
rpm|rpm
rpn|rpn
rpo|rpo
rpp|rpp
rpq|rpq
rpr|rpr
rps|rps
rpt|rpt
rqa|rqa
rqb|rqb
rqc|rqc
rqd|rqd
rqe|rqe
rqf|rqf
rqg|rqg
rqh|rqh
rqi|rqi
rqj|rqj
rqk|rqk
rql|rql
rqm|rqm
rqn|rqn
rqo|rqo
rqp|rqp
rqq|rqq
rqr|rqr
rqs|rqs
rqt|rqt
rra|rra
rrb|rrb
rrc|rrc
rrd|rrd
rre|rre
rrf|rrf
rrg|rrg
rrh|rrh
rri|rri
rrj|rrj
rrk|rrk
rrl|rrl
rrm|rrm
rrn|rrn
rro|rro
rrp|rrp
rrq|rrq
rrr|rrr
rrs|rrs
rrt|rrt
rsa|rsa
rsb|rsb
rsc|rsc
rsd|rsd
rse|rse
rsf|rsf
rsg|rsg
rsh|rsh
rsi|rsi
rsj|rsj
rsk|rsk
rsl|rsl
rsm|rsm
rsn|rsn
rso|rso
rsp|rsp
rsq|rsq
rsr|rsr
rss|rss
rst|rst
rta|rta
rtb|rtb
rtc|rtc
rtd|rtd
rte|rte
rtf|rtf
rtg|rtg
rth|rth
rti|rti
rtj|rtj
rtk|rtk
rtl|rtl
rtm|rtm
rtn|rtn
rto|rto
rtp|rtp
rtq|rtq
rtr|rtr
rts|rts
rtt|rtt
saa|saa
sab|sab
sac|sac
sad|sad
sae|sae
saf|saf
sag|sag
sah|sah
sai|sai
saj|saj
sak|sak
sal|sal
sam|sam
san|san
sao|sao
sap|sap
saq|saq
sar|sar
sas|sas
sat|sat
sba|sba
sbb|sbb
sbc|sbc
sbd|sbd
sbe|sbe
sbf|sbf
sbg|sbg
sbh|sbh
sbi|sbi
sbj|sbj
sbk|sbk
sbl|sbl
sbm|sbm
sbn|sbn
sbo|sbo
sbp|sbp
sbq|sbq
sbr|sbr
sbs|sbs
sbt|sbt
sca|sca
scb|scb
scc|scc
scd|scd
sce|sce
scf|scf
scg|scg
sch|sch
sci|sci
scj|scj
sck|sck
scl|scl
scm|scm
scn|scn
sco|sco
scp|scp
scq|scq
scr|scr
scs|scs
sct|sct
sda|sda
sdb|sdb
sdc|sdc
sdd|sdd
sde|sde
sdf|sdf
sdg|sdg
sdh|sdh
sdi|sdi
sdj|sdj
sdk|sdk
sdl|sdl
sdm|sdm
sdn|sdn
sdo|sdo
sdp|sdp
sdq|sdq
sdr|sdr
sds|sds
sdt|sdt
sea|sea
seb|seb
sec|sec
sed|sed
see|see
sef|sef
seg|seg
seh|seh
sei|sei
sej|sej
sek|sek
sel|sel
sem|sem
sen|sen
seo|seo
sep|sep
seq|seq
ser|ser
ses|ses
set|set
sfa|sfa
sfb|sfb
sfc|sfc
sfd|sfd
sfe|sfe
sff|sff
sfg|sfg
sfh|sfh
sfi|sfi
sfj|sfj
sfk|sfk
sfl|sfl
sfm|sfm
sfn|sfn
sfo|sfo
sfp|sfp
sfq|sfq
sfr|sfr
sfs|sfs
sft|sft
sga|sga
sgb|sgb
sgc|sgc
sgd|sgd
sge|sge
sgf|sgf
sgg|sgg
sgh|sgh
sgi|sgi
sgj|sgj
sgk|sgk
sgl|sgl
sgm|sgm
sgn|sgn
sgo|sgo
sgp|sgp
sgq|sgq
sgr|sgr
sgs|sgs
sgt|sgt
sha|sha
shb|shb
shc|shc
shd|shd
she|she
shf|shf
shg|shg
shh|shh
shi|shi
shj|shj
shk|shk
shl|shl
shm|shm
shn|shn
sho|sho
shp|shp
shq|shq
shr|shr
shs|shs
sht|sht
sia|sia
sib|sib
sic|sic
sid|sid
sie|sie
sif|sif
sig|sig
sih|sih
sii|sii
sij|sij
sik|sik
sil|sil
sim|sim
sin|sin
sio|sio
sip|sip
siq|siq
sir|sir
sis|sis
sit|sit
sja|sja
sjb|sjb
sjc|sjc
sjd|sjd
sje|sje
sjf|sjf
sjg|sjg
sjh|sjh
sji|sji
sjj|sjj
sjk|sjk
sjl|sjl
sjm|sjm
sjn|sjn
sjo|sjo
sjp|sjp
sjq|sjq
sjr|sjr
sjs|sjs
sjt|sjt
ska|ska
skb|skb
skc|skc
skd|skd
ske|ske
skf|skf
skg|skg
skh|skh
ski|ski
skj|skj
skk|skk
skl|skl
skm|skm
skn|skn
sko|sko
skp|skp
skq|skq
skr|skr
sks|sks
skt|skt
sla|sla
slb|slb
slc|slc
sld|sld
sle|sle
slf|slf
slg|slg
slh|slh
sli|sli
slj|slj
slk|slk
sll|sll
slm|slm
sln|sln
slo|slo
slp|slp
slq|slq
slr|slr
sls|sls
slt|slt
sma|sma
smb|smb
smc|smc
smd|smd
sme|sme
smf|smf
smg|smg
smh|smh
smi|smi
smj|smj
smk|smk
sml|sml
smm|smm
smn|smn
smo|smo
smp|smp
smq|smq
smr|smr
sms|sms
smt|smt
sna|sna
snb|snb
snc|snc
snd|snd
sne|sne
snf|snf
sng|sng
snh|snh
sni|sni
snj|snj
snk|snk
snl|snl
snm|snm
snn|snn
sno|sno
snp|snp
snq|snq
snr|snr
sns|sns
snt|snt
soa|soa
sob|sob
soc|soc
sod|sod
soe|soe
sof|sof
sog|sog
soh|soh
soi|soi
soj|soj
sok|sok
sol|sol
som|som
son|son
soo|soo
sop|sop
soq|soq
sor|sor
sos|sos
sot|sot
spa|spa
spb|spb
spc|spc
spd|spd
spe|spe
spf|spf
spg|spg
sph|sph
spi|spi
spj|spj
spk|spk
spl|spl
spm|spm
spn|spn
spo|spo
spp|spp
spq|spq
spr|spr
sps|sps
spt|spt
sqa|sqa
sqb|sqb
sqc|sqc
sqd|sqd
sqe|sqe
sqf|sqf
sqg|sqg
sqh|sqh
sqi|sqi
sqj|sqj
sqk|sqk
sql|sql
sqm|sqm
sqn|sqn
sqo|sqo
sqp|sqp
sqq|sqq
sqr|sqr
sqs|sqs
sqt|sqt
sra|sra
srb|srb
src|src
srd|srd
sre|sre
srf|srf
srg|srg
srh|srh
sri|sri
srj|srj
srk|srk
srl|srl
srm|srm
srn|srn
sro|sro
srp|srp
srq|srq
srr|srr
srs|srs
srt|srt
ssa|ssa
ssb|ssb
ssc|ssc
ssd|ssd
sse|sse
ssf|ssf
ssg|ssg
ssh|ssh
ssi|ssi
ssj|ssj
ssk|ssk
ssl|ssl
ssm|ssm
ssn|ssn
sso|sso
ssp|ssp
ssq|ssq
ssr|ssr
sss|sss
sst|sst
sta|sta
stb|stb
stc|stc
std|std
ste|ste
stf|stf
stg|stg
sth|sth
sti|sti
stj|stj
stk|stk
stl|stl
stm|stm
stn|stn
sto|sto
stp|stp
stq|stq
str|str
sts|sts
stt|stt
taa|taa
tab|tab
tac|tac
tad|tad
tae|tae
taf|taf
tag|tag
tah|tah
tai|tai
taj|taj
tak|tak
tal|tal
tam|tam
tan|tan
tao|tao
tap|tap
taq|taq
tar|tar
tas|tas
tat|tat
tba|tba
tbb|tbb
tbc|tbc
tbd|tbd
tbe|tbe
tbf|tbf
tbg|tbg
tbh|tbh
tbi|tbi
tbj|tbj
tbk|tbk
tbl|tbl
tbm|tbm
tbn|tbn
tbo|tbo
tbp|tbp
tbq|tbq
tbr|tbr
tbs|tbs
tbt|tbt
tca|tca
tcb|tcb
tcc|tcc
tcd|tcd
tce|tce
tcf|tcf
tcg|tcg
tch|tch
tci|tci
tcj|tcj
tck|tck
tcl|tcl
tcm|tcm
tcn|tcn
tco|tco
tcp|tcp
tcq|tcq
tcr|tcr
tcs|tcs
tct|tct
tda|tda
tdb|tdb
tdc|tdc
tdd|tdd
tde|tde
tdf|tdf
tdg|tdg
tdh|tdh
tdi|tdi
tdj|tdj
tdk|tdk
tdl|tdl
tdm|tdm
tdn|tdn
tdo|tdo
tdp|tdp
tdq|tdq
tdr|tdr
tds|tds
tdt|tdt
tea|tea
teb|teb
tec|tec
ted|ted
tee|tee
tef|tef
teg|teg
teh|teh
tei|tei
tej|tej
tek|tek
tel|tel
tem|tem
ten|ten
teo|teo
tep|tep
teq|teq
ter|ter
tes|tes
tet|tet
tfa|tfa
tfb|tfb
tfc|tfc
tfd|tfd
tfe|tfe
tff|tff
tfg|tfg
tfh|tfh
tfi|tfi
tfj|tfj
tfk|tfk
tfl|tfl
tfm|tfm
tfn|tfn
tfo|tfo
tfp|tfp
tfq|tfq
tfr|tfr
tfs|tfs
tft|tft
tga|tga
tgb|tgb
tgc|tgc
tgd|tgd
tge|tge
tgf|tgf
tgg|tgg
tgh|tgh
tgi|tgi
tgj|tgj
tgk|tgk
tgl|tgl
tgm|tgm
tgn|tgn
tgo|tgo
tgp|tgp
tgq|tgq
tgr|tgr
tgs|tgs
tgt|tgt
tha|tha
thb|thb
thc|thc
thd|thd
the|the
thf|thf
thg|thg
thh|thh
thi|thi
thj|thj
thk|thk
thl|thl
thm|thm
thn|thn
tho|tho
thp|thp
thq|thq
thr|thr
ths|ths
tht|tht
tia|tia
tib|tib
tic|tic
tid|tid
tie|tie
tif|tif
tig|tig
tih|tih
tii|tii
tij|tij
tik|tik
til|til
tim|tim
tin|tin
tio|tio
tip|tip
tiq|tiq
tir|tir
tis|tis
tit|tit
tja|tja
tjb|tjb
tjc|tjc
tjd|tjd
tje|tje
tjf|tjf
tjg|tjg
tjh|tjh
tji|tji
tjj|tjj
tjk|tjk
tjl|tjl
tjm|tjm
tjn|tjn
tjo|tjo
tjp|tjp
tjq|tjq
tjr|tjr
tjs|tjs
tjt|tjt
tka|tka
tkb|tkb
tkc|tkc
tkd|tkd
tke|tke
tkf|tkf
tkg|tkg
tkh|tkh
tki|tki
tkj|tkj
tkk|tkk
tkl|tkl
tkm|tkm
tkn|tkn
tko|tko
tkp|tkp
tkq|tkq
tkr|tkr
tks|tks
tkt|tkt
tla|tla
tlb|tlb
tlc|tlc
tld|tld
tle|tle
tlf|tlf
tlg|tlg
tlh|tlh
tli|tli
tlj|tlj
tlk|tlk
tll|tll
tlm|tlm
tln|tln
tlo|tlo
tlp|tlp
tlq|tlq
tlr|tlr
tls|tls
tlt|tlt
tma|tma
tmb|tmb
tmc|tmc
tmd|tmd
tme|tme
tmf|tmf
tmg|tmg
tmh|tmh
tmi|tmi
tmj|tmj
tmk|tmk
tml|tml
tmm|tmm
tmn|tmn
tmo|tmo
tmp|tmp
tmq|tmq
tmr|tmr
tms|tms
tmt|tmt
tna|tna
tnb|tnb
tnc|tnc
tnd|tnd
tne|tne
tnf|tnf
tng|tng
tnh|tnh
tni|tni
tnj|tnj
tnk|tnk
tnl|tnl
tnm|tnm
tnn|tnn
tno|tno
tnp|tnp
tnq|tnq
tnr|tnr
tns|tns
tnt|tnt
toa|toa
tob|tob
toc|toc
tod|tod
toe|toe
tof|tof
tog|tog
toh|toh
toi|toi
toj|toj
tok|tok
tol|tol
tom|tom
ton|ton
too|too
top|top
toq|toq
tor|tor
tos|tos
tot|tot
tpa|tpa
tpb|tpb
tpc|tpc
tpd|tpd
tpe|tpe
tpf|tpf
tpg|tpg
tph|tph
tpi|tpi
tpj|tpj
tpk|tpk
tpl|tpl
tpm|tpm
tpn|tpn
tpo|tpo
tpp|tpp
tpq|tpq
tpr|tpr
tps|tps
tpt|tpt
tqa|tqa
tqb|tqb
tqc|tqc
tqd|tqd
tqe|tqe
tqf|tqf
tqg|tqg
tqh|tqh
tqi|tqi
tqj|tqj
tqk|tqk
tql|tql
tqm|tqm
tqn|tqn
tqo|tqo
tqp|tqp
tqq|tqq
tqr|tqr
tqs|tqs
tqt|tqt
tra|tra
trb|trb
trc|trc
trd|trd
tre|tre
trf|trf
trg|trg
trh|trh
tri|tri
trj|trj
trk|trk
trl|trl
trm|trm
trn|trn
tro|tro
trp|trp
trq|trq
trr|trr
trs|trs
trt|trt
tsa|tsa
tsb|tsb
tsc|tsc
tsd|tsd
tse|tse
tsf|tsf
tsg|tsg
tsh|tsh
tsi|tsi
tsj|tsj
tsk|tsk
tsl|tsl
tsm|tsm
tsn|tsn
tso|tso
tsp|tsp
tsq|tsq
tsr|tsr
tss|tss
tst|tst
tta|tta
ttb|ttb
ttc|ttc
ttd|ttd
tte|tte
ttf|ttf
ttg|ttg
tth|tth
tti|tti
ttj|ttj
ttk|ttk
ttl|ttl
ttm|ttm
ttn|ttn
tto|tto
ttp|ttp
ttq|ttq
ttr|ttr
tts|tts
ttt|ttt
baaa|baaa
baab|baab
baac|baac
baad|baad
baae|baae
baaf|baaf
baag|baag
baah|baah
baai|baai
baaj|baaj
baak|baak
baal|baal
baam|baam
baan|baan
baao|baao
baap|baap
baaq|baaq
baar|baar
baas|baas
baat|baat
baba|baba
babb|babb
babc|babc
babd|babd
babe|babe
babf|babf
babg|babg
babh|babh
babi|babi
babj|babj
babk|babk
babl|babl
babm|babm
babn|babn
babo|babo
babp|babp
babq|babq
babr|babr
babs|babs
babt|babt
baca|baca
bacb|bacb
bacc|bacc
bacd|bacd
bace|bace
bacf|bacf
bacg|bacg
bach|bach
baci|baci
bacj|bacj
back|back
bacl|bacl
bacm|bacm
bacn|bacn
baco|baco
bacp|bacp
bacq|bacq
bacr|bacr
bacs|bacs
bact|bact
bada|bada
badb|badb
badc|badc
badd|badd
bade|bade
badf|badf
badg|badg
badh|badh
badi|badi
badj|badj
badk|badk
badl|badl
badm|badm
badn|badn
bado|bado
badp|badp
badq|badq
badr|badr
bads|bads
badt|badt
baea|baea
baeb|baeb
baec|baec
baed|baed
baee|baee
baef|baef
baeg|baeg
baeh|baeh
baei|baei
baej|baej
baek|baek
bael|bael
baem|baem
baen|baen
baeo|baeo
baep|baep
baeq|baeq
baer|baer
baes|baes
baet|baet
bafa|bafa
bafb|bafb
bafc|bafc
bafd|bafd
bafe|bafe
baff|baff
bafg|bafg
bafh|bafh
bafi|bafi
bafj|bafj
bafk|bafk
bafl|bafl
bafm|bafm
bafn|bafn
bafo|bafo
bafp|bafp
bafq|bafq
bafr|bafr
bafs|bafs
baft|baft
baga|baga
bagb|bagb
bagc|bagc
bagd|bagd
bage|bage
bagf|bagf
bagg|bagg
bagh|bagh
bagi|bagi
bagj|bagj
bagk|bagk
bagl|bagl
bagm|bagm
bagn|bagn
bago|bago
bagp|bagp
bagq|bagq
bagr|bagr
bags|bags
bagt|bagt
baha|baha
bahb|bahb
bahc|bahc
bahd|bahd
bahe|bahe
bahf|bahf
bahg|bahg
bahh|bahh
bahi|bahi
bahj|bahj
bahk|bahk
bahl|bahl
bahm|bahm
bahn|bahn
baho|baho
bahp|bahp
bahq|bahq
bahr|bahr
bahs|bahs
baht|baht
baia|baia
baib|baib
baic|baic
baid|baid
baie|baie
baif|baif
baig|baig
baih|baih
baii|baii
baij|baij
baik|baik
bail|bail
baim|baim
bain|bain
baio|baio
baip|baip
baiq|baiq
bair|bair
bais|bais
bait|bait
baja|baja
bajb|bajb
bajc|bajc
bajd|bajd
baje|baje
bajf|bajf
bajg|bajg
bajh|bajh
baji|baji
bajj|bajj
bajk|bajk
bajl|bajl
bajm|bajm
bajn|bajn
bajo|bajo
bajp|bajp
bajq|bajq
bajr|bajr
bajs|bajs
bajt|bajt
baka|baka
bakb|bakb
bakc|bakc
bakd|bakd
bake|bake
bakf|bakf
bakg|bakg
bakh|bakh
baki|baki
bakj|bakj
bakk|bakk
bakl|bakl
bakm|bakm
bakn|bakn
bako|bako
bakp|bakp
bakq|bakq
bakr|bakr
baks|baks
bakt|bakt
bala|bala
balb|balb
balc|balc
bald|bald
bale|bale
balf|balf
balg|balg
balh|balh
bali|bali
balj|balj
balk|balk
ball|ball
balm|balm
baln|baln
balo|balo
balp|balp
balq|balq
balr|balr
bals|bals
balt|balt
bama|bama
bamb|bamb
bamc|bamc
bamd|bamd
bame|bame
bamf|bamf
bamg|bamg
bamh|bamh
bami|bami
bamj|bamj
bamk|bamk
baml|baml
bamm|bamm
bamn|bamn
bamo|bamo
bamp|bamp
bamq|bamq
bamr|bamr
bams|bams
bamt|bamt
bana|bana
banb|banb
banc|banc
band|band
bane|bane
banf|banf
bang|bang
banh|banh
bani|bani
banj|banj
bank|bank
banl|banl
banm|banm
bann|bann
bano|bano
banp|banp
banq|banq
banr|banr
bans|bans
bant|bant
baoa|baoa
baob|baob
baoc|baoc
baod|baod
baoe|baoe
baof|baof
baog|baog
baoh|baoh
baoi|baoi
baoj|baoj
baok|baok
baol|baol
baom|baom
baon|baon
baoo|baoo
baop|baop
baoq|baoq
baor|baor
baos|baos
baot|baot
bapa|bapa
bapb|bapb
bapc|bapc
bapd|bapd
bape|bape
bapf|bapf
bapg|bapg
baph|baph
bapi|bapi
bapj|bapj
bapk|bapk
bapl|bapl
bapm|bapm
bapn|bapn
bapo|bapo
bapp|bapp
bapq|bapq
bapr|bapr
baps|baps
bapt|bapt
baqa|baqa
baqb|baqb
baqc|baqc
baqd|baqd
baqe|baqe
baqf|baqf
baqg|baqg
baqh|baqh
baqi|baqi
baqj|baqj
baqk|baqk
baql|baql
baqm|baqm
baqn|baqn
baqo|baqo
baqp|baqp
baqq|baqq
baqr|baqr
baqs|baqs
baqt|baqt
bara|bara
barb|barb
barc|barc
bard|bard
bare|bare
barf|barf
barg|barg
barh|barh
bari|bari
barj|barj
bark|bark
barl|barl
barm|barm
barn|barn
baro|baro
barp|barp
barq|barq
barr|barr
bars|bars
bart|bart
basa|basa
basb|basb
basc|basc
basd|basd
base|base
basf|basf
basg|basg
bash|bash
basi|basi
basj|basj
bask|bask
basl|basl
basm|basm
basn|basn
baso|baso
basp|basp
basq|basq
basr|basr
bass|bass
bast|bast
bata|bata
batb|batb
batc|batc
batd|batd
bate|bate
batf|batf
batg|batg
bath|bath
bati|bati
batj|batj
batk|batk
batl|batl
batm|batm
batn|batn
bato|bato
batp|batp
batq|batq
batr|batr
bats|bats
batt|batt
bbaa|bbaa
bbab|bbab
bbac|bbac
bbad|bbad
bbae|bbae
bbaf|bbaf
bbag|bbag
bbah|bbah
bbai|bbai
bbaj|bbaj
bbak|bbak
bbal|bbal
bbam|bbam
bban|bban
bbao|bbao
bbap|bbap
bbaq|bbaq
bbar|bbar
bbas|bbas
bbat|bbat
bbba|bbba
bbbb|bbbb
bbbc|bbbc
bbbd|bbbd
bbbe|bbbe
bbbf|bbbf
bbbg|bbbg
bbbh|bbbh
bbbi|bbbi
bbbj|bbbj
bbbk|bbbk
bbbl|bbbl
bbbm|bbbm
bbbn|bbbn
bbbo|bbbo
bbbp|bbbp
bbbq|bbbq
bbbr|bbbr
bbbs|bbbs
bbbt|bbbt
bbca|bbca
bbcb|bbcb
bbcc|bbcc
bbcd|bbcd
bbce|bbce
bbcf|bbcf
bbcg|bbcg
bbch|bbch
bbci|bbci
bbcj|bbcj
bbck|bbck
bbcl|bbcl
bbcm|bbcm
bbcn|bbcn
bbco|bbco
bbcp|bbcp
bbcq|bbcq
bbcr|bbcr
bbcs|bbcs
bbct|bbct
bbda|bbda
bbdb|bbdb
bbdc|bbdc
bbdd|bbdd
bbde|bbde
bbdf|bbdf
bbdg|bbdg
bbdh|bbdh
bbdi|bbdi
bbdj|bbdj
bbdk|bbdk
bbdl|bbdl
bbdm|bbdm
bbdn|bbdn
bbdo|bbdo
bbdp|bbdp
bbdq|bbdq
bbdr|bbdr
bbds|bbds
bbdt|bbdt
bbea|bbea
bbeb|bbeb
bbec|bbec
bbed|bbed
bbee|bbee
bbef|bbef
bbeg|bbeg
bbeh|bbeh
bbei|bbei
bbej|bbej
bbek|bbek
bbel|bbel
bbem|bbem
bben|bben
bbeo|bbeo
bbep|bbep
bbeq|bbeq
bber|bber
bbes|bbes
bbet|bbet
bbfa|bbfa
bbfb|bbfb
bbfc|bbfc
bbfd|bbfd
bbfe|bbfe
bbff|bbff
bbfg|bbfg
bbfh|bbfh
bbfi|bbfi
bbfj|bbfj
bbfk|bbfk
bbfl|bbfl
bbfm|bbfm
bbfn|bbfn
bbfo|bbfo
bbfp|bbfp
bbfq|bbfq
bbfr|bbfr
bbfs|bbfs
bbft|bbft
bbga|bbga
bbgb|bbgb
bbgc|bbgc
bbgd|bbgd
bbge|bbge
bbgf|bbgf
bbgg|bbgg
bbgh|bbgh
bbgi|bbgi
bbgj|bbgj
bbgk|bbgk
bbgl|bbgl
bbgm|bbgm
bbgn|bbgn
bbgo|bbgo
bbgp|bbgp
bbgq|bbgq
bbgr|bbgr
bbgs|bbgs
bbgt|bbgt
bbha|bbha
bbhb|bbhb
bbhc|bbhc
bbhd|bbhd
bbhe|bbhe
bbhf|bbhf
bbhg|bbhg
bbhh|bbhh
bbhi|bbhi
bbhj|bbhj
bbhk|bbhk
bbhl|bbhl
bbhm|bbhm
bbhn|bbhn
bbho|bbho
bbhp|bbhp
bbhq|bbhq
bbhr|bbhr
bbhs|bbhs
bbht|bbht
bbia|bbia
bbib|bbib
bbic|bbic
bbid|bbid
bbie|bbie
bbif|bbif
bbig|bbig
bbih|bbih
bbii|bbii
bbij|bbij
bbik|bbik
bbil|bbil
bbim|bbim
bbin|bbin
bbio|bbio
bbip|bbip
bbiq|bbiq
bbir|bbir
bbis|bbis
bbit|bbit
bbja|bbja
bbjb|bbjb
bbjc|bbjc
bbjd|bbjd
bbje|bbje
bbjf|bbjf
bbjg|bbjg
bbjh|bbjh
bbji|bbji
bbjj|bbjj
bbjk|bbjk
bbjl|bbjl
bbjm|bbjm
bbjn|bbjn
bbjo|bbjo
bbjp|bbjp
bbjq|bbjq
bbjr|bbjr
bbjs|bbjs
bbjt|bbjt
bbka|bbka
bbkb|bbkb
bbkc|bbkc
bbkd|bbkd
bbke|bbke
bbkf|bbkf
bbkg|bbkg
bbkh|bbkh
bbki|bbki
bbkj|bbkj
bbkk|bbkk
bbkl|bbkl
bbkm|bbkm
bbkn|bbkn
bbko|bbko
bbkp|bbkp
bbkq|bbkq
bbkr|bbkr
bbks|bbks
bbkt|bbkt
bbla|bbla
bblb|bblb
bblc|bblc
bbld|bbld
bble|bble
bblf|bblf
bblg|bblg
bblh|bblh
bbli|bbli
bblj|bblj
bblk|bblk
bbll|bbll
bblm|bblm
bbln|bbln
bblo|bblo
bblp|bblp
bblq|bblq
bblr|bblr
bbls|bbls
bblt|bblt
bbma|bbma
bbmb|bbmb
bbmc|bbmc
bbmd|bbmd
bbme|bbme
bbmf|bbmf
bbmg|bbmg
bbmh|bbmh
bbmi|bbmi
bbmj|bbmj
bbmk|bbmk
bbml|bbml
bbmm|bbmm
bbmn|bbmn
bbmo|bbmo
bbmp|bbmp
bbmq|bbmq
bbmr|bbmr
bbms|bbms
bbmt|bbmt
bbna|bbna
bbnb|bbnb
bbnc|bbnc
bbnd|bbnd
bbne|bbne
bbnf|bbnf
bbng|bbng
bbnh|bbnh
bbni|bbni
bbnj|bbnj
bbnk|bbnk
bbnl|bbnl
bbnm|bbnm
bbnn|bbnn
bbno|bbno
bbnp|bbnp
bbnq|bbnq
bbnr|bbnr
bbns|bbns
bbnt|bbnt
bboa|bboa
bbob|bbob
bboc|bboc
bbod|bbod
bboe|bboe
bbof|bbof
bbog|bbog
bboh|bboh
bboi|bboi
bboj|bboj
bbok|bbok
bbol|bbol
bbom|bbom
bbon|bbon
bboo|bboo
bbop|bbop
bboq|bboq
bbor|bbor
bbos|bbos
bbot|bbot
bbpa|bbpa
bbpb|bbpb
bbpc|bbpc
bbpd|bbpd
bbpe|bbpe
bbpf|bbpf
bbpg|bbpg
bbph|bbph
bbpi|bbpi
bbpj|bbpj
bbpk|bbpk
bbpl|bbpl
bbpm|bbpm
bbpn|bbpn
bbpo|bbpo
bbpp|bbpp
bbpq|bbpq
bbpr|bbpr
bbps|bbps
bbpt|bbpt
bbqa|bbqa
bbqb|bbqb
bbqc|bbqc
bbqd|bbqd
bbqe|bbqe
bbqf|bbqf
bbqg|bbqg
bbqh|bbqh
bbqi|bbqi
bbqj|bbqj
bbqk|bbqk
bbql|bbql
bbqm|bbqm
bbqn|bbqn
bbqo|bbqo
bbqp|bbqp
bbqq|bbqq
bbqr|bbqr
bbqs|bbqs
bbqt|bbqt
bbra|bbra
bbrb|bbrb
bbrc|bbrc
bbrd|bbrd
bbre|bbre
bbrf|bbrf
bbrg|bbrg
bbrh|bbrh
bbri|bbri
bbrj|bbrj
bbrk|bbrk
bbrl|bbrl
bbrm|bbrm
bbrn|bbrn
bbro|bbro
bbrp|bbrp
bbrq|bbrq
bbrr|bbrr
bbrs|bbrs
bbrt|bbrt
bbsa|bbsa
bbsb|bbsb
bbsc|bbsc
bbsd|bbsd
bbse|bbse
bbsf|bbsf
bbsg|bbsg
bbsh|bbsh
bbsi|bbsi
bbsj|bbsj
bbsk|bbsk
bbsl|bbsl
bbsm|bbsm
bbsn|bbsn
bbso|bbso
bbsp|bbsp
bbsq|bbsq
bbsr|bbsr
bbss|bbss
bbst|bbst
bbta|bbta
bbtb|bbtb
bbtc|bbtc
bbtd|bbtd
bbte|bbte
bbtf|bbtf
bbtg|bbtg
bbth|bbth
bbti|bbti
bbtj|bbtj
bbtk|bbtk
bbtl|bbtl
bbtm|bbtm
bbtn|bbtn
bbto|bbto
bbtp|bbtp
bbtq|bbtq
bbtr|bbtr
bbts|bbts
bbtt|bbtt
bcaa|bcaa
bcab|bcab
bcac|bcac
bcad|bcad
bcae|bcae
bcaf|bcaf
bcag|bcag
bcah|bcah
bcai|bcai
bcaj|bcaj
bcak|bcak
bcal|bcal
bcam|bcam
bcan|bcan
bcao|bcao
bcap|bcap
bcaq|bcaq
bcar|bcar
bcas|bcas
bcat|bcat
bcba|bcba
bcbb|bcbb
bcbc|bcbc
bcbd|bcbd
bcbe|bcbe
bcbf|bcbf
bcbg|bcbg
bcbh|bcbh
bcbi|bcbi
bcbj|bcbj
bcbk|bcbk
bcbl|bcbl
bcbm|bcbm
bcbn|bcbn
bcbo|bcbo
bcbp|bcbp
bcbq|bcbq
bcbr|bcbr
bcbs|bcbs
bcbt|bcbt
bcca|bcca
bccb|bccb
bccc|bccc
bccd|bccd
bcce|bcce
bccf|bccf
bccg|bccg
bcch|bcch
bcci|bcci
bccj|bccj
bcck|bcck
bccl|bccl
bccm|bccm
bccn|bccn
bcco|bcco
bccp|bccp
bccq|bccq
bccr|bccr
bccs|bccs
bcct|bcct
bcda|bcda
bcdb|bcdb
bcdc|bcdc
bcdd|bcdd
bcde|bcde
bcdf|bcdf
bcdg|bcdg
bcdh|bcdh
bcdi|bcdi
bcdj|bcdj
bcdk|bcdk
bcdl|bcdl
bcdm|bcdm
bcdn|bcdn
bcdo|bcdo
bcdp|bcdp
bcdq|bcdq
bcdr|bcdr
bcds|bcds
bcdt|bcdt
bcea|bcea
bceb|bceb
bcec|bcec
bced|bced
bcee|bcee
bcef|bcef
bceg|bceg
bceh|bceh
bcei|bcei
bcej|bcej
bcek|bcek
bcel|bcel
bcem|bcem
bcen|bcen
bceo|bceo
bcep|bcep
bceq|bceq
bcer|bcer
bces|bces
bcet|bcet
bcfa|bcfa
bcfb|bcfb
bcfc|bcfc
bcfd|bcfd
bcfe|bcfe
bcff|bcff
bcfg|bcfg
bcfh|bcfh
bcfi|bcfi
bcfj|bcfj
bcfk|bcfk
bcfl|bcfl
bcfm|bcfm
bcfn|bcfn
bcfo|bcfo
bcfp|bcfp
bcfq|bcfq
bcfr|bcfr
bcfs|bcfs
bcft|bcft
bcga|bcga
bcgb|bcgb
bcgc|bcgc
bcgd|bcgd
bcge|bcge
bcgf|bcgf
bcgg|bcgg
bcgh|bcgh
bcgi|bcgi
bcgj|bcgj
bcgk|bcgk
bcgl|bcgl
bcgm|bcgm
bcgn|bcgn
bcgo|bcgo
bcgp|bcgp
bcgq|bcgq
bcgr|bcgr
bcgs|bcgs
bcgt|bcgt
bcha|bcha
bchb|bchb
bchc|bchc
bchd|bchd
bche|bche
bchf|bchf
bchg|bchg
bchh|bchh
bchi|bchi
bchj|bchj
bchk|bchk
bchl|bchl
bchm|bchm
bchn|bchn
bcho|bcho
bchp|bchp
bchq|bchq
bchr|bchr
bchs|bchs
bcht|bcht
bcia|bcia
bcib|bcib
bcic|bcic
bcid|bcid
bcie|bcie
bcif|bcif
bcig|bcig
bcih|bcih
bcii|bcii
bcij|bcij
bcik|bcik
bcil|bcil
bcim|bcim
bcin|bcin
bcio|bcio
bcip|bcip
bciq|bciq
bcir|bcir
bcis|bcis
bcit|bcit
bcja|bcja
bcjb|bcjb
bcjc|bcjc
bcjd|bcjd
bcje|bcje
bcjf|bcjf
bcjg|bcjg
bcjh|bcjh
bcji|bcji
bcjj|bcjj
bcjk|bcjk
bcjl|bcjl
bcjm|bcjm
bcjn|bcjn
bcjo|bcjo
bcjp|bcjp
bcjq|bcjq
bcjr|bcjr
bcjs|bcjs
bcjt|bcjt
bcka|bcka
bckb|bckb
bckc|bckc
bckd|bckd
bcke|bcke
bckf|bckf
bckg|bckg
bckh|bckh
bcki|bcki
bckj|bckj
bckk|bckk
bckl|bckl
bckm|bckm
bckn|bckn
bcko|bcko
bckp|bckp
bckq|bckq
bckr|bckr
bcks|bcks
bckt|bckt
bcla|bcla
bclb|bclb
bclc|bclc
bcld|bcld
bcle|bcle
bclf|bclf
bclg|bclg
bclh|bclh
bcli|bcli
bclj|bclj
bclk|bclk
bcll|bcll
bclm|bclm
bcln|bcln
bclo|bclo
bclp|bclp
bclq|bclq
bclr|bclr
bcls|bcls
bclt|bclt
bcma|bcma
bcmb|bcmb
bcmc|bcmc
bcmd|bcmd
bcme|bcme
bcmf|bcmf
bcmg|bcmg
bcmh|bcmh
bcmi|bcmi
bcmj|bcmj
bcmk|bcmk
bcml|bcml
bcmm|bcmm
bcmn|bcmn
bcmo|bcmo
bcmp|bcmp
bcmq|bcmq
bcmr|bcmr
bcms|bcms
bcmt|bcmt
bcna|bcna
bcnb|bcnb
bcnc|bcnc
bcnd|bcnd
bcne|bcne
bcnf|bcnf
bcng|bcng
bcnh|bcnh
bcni|bcni
bcnj|bcnj
bcnk|bcnk
bcnl|bcnl
bcnm|bcnm
bcnn|bcnn
bcno|bcno
bcnp|bcnp
bcnq|bcnq
bcnr|bcnr
bcns|bcns
bcnt|bcnt
bcoa|bcoa
bcob|bcob
bcoc|bcoc
bcod|bcod
bcoe|bcoe
bcof|bcof
bcog|bcog
bcoh|bcoh
bcoi|bcoi
bcoj|bcoj
bcok|bcok
bcol|bcol
bcom|bcom
bcon|bcon
bcoo|bcoo
bcop|bcop
bcoq|bcoq
bcor|bcor
bcos|bcos
bcot|bcot
bcpa|bcpa
bcpb|bcpb
bcpc|bcpc
bcpd|bcpd
bcpe|bcpe
bcpf|bcpf
bcpg|bcpg
bcph|bcph
bcpi|bcpi
bcpj|bcpj
bcpk|bcpk
bcpl|bcpl
bcpm|bcpm
bcpn|bcpn
bcpo|bcpo
bcpp|bcpp
bcpq|bcpq
bcpr|bcpr
bcps|bcps
bcpt|bcpt
bcqa|bcqa
bcqb|bcqb
bcqc|bcqc
bcqd|bcqd
bcqe|bcqe
bcqf|bcqf
bcqg|bcqg
bcqh|bcqh
bcqi|bcqi
bcqj|bcqj
bcqk|bcqk
bcql|bcql
bcqm|bcqm
bcqn|bcqn
bcqo|bcqo
bcqp|bcqp
bcqq|bcqq
bcqr|bcqr
bcqs|bcqs
bcqt|bcqt
bcra|bcra
bcrb|bcrb
bcrc|bcrc
bcrd|bcrd
bcre|bcre
bcrf|bcrf
bcrg|bcrg
bcrh|bcrh
bcri|bcri
bcrj|bcrj
bcrk|bcrk
bcrl|bcrl
bcrm|bcrm
bcrn|bcrn
bcro|bcro
bcrp|bcrp
bcrq|bcrq
bcrr|bcrr
bcrs|bcrs
bcrt|bcrt
bcsa|bcsa
bcsb|bcsb
bcsc|bcsc
bcsd|bcsd
bcse|bcse
bcsf|bcsf
bcsg|bcsg
bcsh|bcsh
bcsi|bcsi
bcsj|bcsj
bcsk|bcsk
bcsl|bcsl
bcsm|bcsm
bcsn|bcsn
bcso|bcso
bcsp|bcsp
bcsq|bcsq
bcsr|bcsr
bcss|bcss
bcst|bcst
bcta|bcta
bctb|bctb
bctc|bctc
bctd|bctd
bcte|bcte
bctf|bctf
bctg|bctg
bcth|bcth
bcti|bcti
bctj|bctj
bctk|bctk
bctl|bctl
bctm|bctm
bctn|bctn
bcto|bcto
bctp|bctp
bctq|bctq
bctr|bctr
bcts|bcts
bctt|bctt
bdaa|bdaa
bdab|bdab
bdac|bdac
bdad|bdad
bdae|bdae
bdaf|bdaf
bdag|bdag
bdah|bdah
bdai|bdai
bdaj|bdaj
bdak|bdak
bdal|bdal
bdam|bdam
bdan|bdan
bdao|bdao
bdap|bdap
bdaq|bdaq
bdar|bdar
bdas|bdas
bdat|bdat
bdba|bdba
bdbb|bdbb
bdbc|bdbc
bdbd|bdbd
bdbe|bdbe
bdbf|bdbf
bdbg|bdbg
bdbh|bdbh
bdbi|bdbi
bdbj|bdbj
bdbk|bdbk
bdbl|bdbl
bdbm|bdbm
bdbn|bdbn
bdbo|bdbo
bdbp|bdbp
bdbq|bdbq
bdbr|bdbr
bdbs|bdbs
bdbt|bdbt
bdca|bdca
bdcb|bdcb
bdcc|bdcc
bdcd|bdcd
bdce|bdce
bdcf|bdcf
bdcg|bdcg
bdch|bdch
bdci|bdci
bdcj|bdcj
bdck|bdck
bdcl|bdcl
bdcm|bdcm
bdcn|bdcn
bdco|bdco
bdcp|bdcp
bdcq|bdcq
bdcr|bdcr
bdcs|bdcs
bdct|bdct
bdda|bdda
bddb|bddb
bddc|bddc
bddd|bddd
bdde|bdde
bddf|bddf
bddg|bddg
bddh|bddh
bddi|bddi
bddj|bddj
bddk|bddk
bddl|bddl
bddm|bddm
bddn|bddn
bddo|bddo
bddp|bddp
bddq|bddq
bddr|bddr
bdds|bdds
bddt|bddt
bdea|bdea
bdeb|bdeb
bdec|bdec
bded|bded
bdee|bdee
bdef|bdef
bdeg|bdeg
bdeh|bdeh
bdei|bdei
bdej|bdej
bdek|bdek
bdel|bdel
bdem|bdem
bden|bden
bdeo|bdeo
bdep|bdep
bdeq|bdeq
bder|bder
bdes|bdes
bdet|bdet
bdfa|bdfa
bdfb|bdfb
bdfc|bdfc
bdfd|bdfd
bdfe|bdfe
bdff|bdff
bdfg|bdfg
bdfh|bdfh
bdfi|bdfi
bdfj|bdfj
bdfk|bdfk
bdfl|bdfl
bdfm|bdfm
bdfn|bdfn
bdfo|bdfo
bdfp|bdfp
bdfq|bdfq
bdfr|bdfr
bdfs|bdfs
bdft|bdft
bdga|bdga
bdgb|bdgb
bdgc|bdgc
bdgd|bdgd
bdge|bdge
bdgf|bdgf
bdgg|bdgg
bdgh|bdgh
bdgi|bdgi
bdgj|bdgj
bdgk|bdgk
bdgl|bdgl
bdgm|bdgm
bdgn|bdgn
bdgo|bdgo
bdgp|bdgp
bdgq|bdgq
bdgr|bdgr
bdgs|bdgs
bdgt|bdgt
bdha|bdha
bdhb|bdhb
bdhc|bdhc
bdhd|bdhd
bdhe|bdhe
bdhf|bdhf
bdhg|bdhg
bdhh|bdhh
bdhi|bdhi
bdhj|bdhj
bdhk|bdhk
bdhl|bdhl
bdhm|bdhm
bdhn|bdhn
bdho|bdho
bdhp|bdhp
bdhq|bdhq
bdhr|bdhr
bdhs|bdhs
bdht|bdht
bdia|bdia
bdib|bdib
bdic|bdic
bdid|bdid
bdie|bdie
bdif|bdif
bdig|bdig
bdih|bdih
bdii|bdii
bdij|bdij
bdik|bdik
bdil|bdil
bdim|bdim
bdin|bdin
bdio|bdio
bdip|bdip
bdiq|bdiq
bdir|bdir
bdis|bdis
bdit|bdit
bdja|bdja
bdjb|bdjb
bdjc|bdjc
bdjd|bdjd
bdje|bdje
bdjf|bdjf
bdjg|bdjg
bdjh|bdjh
bdji|bdji
bdjj|bdjj
bdjk|bdjk
bdjl|bdjl
bdjm|bdjm
bdjn|bdjn
bdjo|bdjo
bdjp|bdjp
bdjq|bdjq
bdjr|bdjr
bdjs|bdjs
bdjt|bdjt
bdka|bdka
bdkb|bdkb
bdkc|bdkc
bdkd|bdkd
bdke|bdke
bdkf|bdkf
bdkg|bdkg
bdkh|bdkh
bdki|bdki
bdkj|bdkj
bdkk|bdkk
bdkl|bdkl
bdkm|bdkm
bdkn|bdkn
bdko|bdko
bdkp|bdkp
bdkq|bdkq
bdkr|bdkr
bdks|bdks
bdkt|bdkt
bdla|bdla
bdlb|bdlb
bdlc|bdlc
bdld|bdld
bdle|bdle
bdlf|bdlf
bdlg|bdlg
bdlh|bdlh
bdli|bdli
bdlj|bdlj
bdlk|bdlk
bdll|bdll
bdlm|bdlm
bdln|bdln
bdlo|bdlo
bdlp|bdlp
bdlq|bdlq
bdlr|bdlr
bdls|bdls
bdlt|bdlt
bdma|bdma
bdmb|bdmb
bdmc|bdmc
bdmd|bdmd
bdme|bdme
bdmf|bdmf
bdmg|bdmg
bdmh|bdmh
bdmi|bdmi
bdmj|bdmj
bdmk|bdmk
bdml|bdml
bdmm|bdmm
bdmn|bdmn
bdmo|bdmo
bdmp|bdmp
bdmq|bdmq
bdmr|bdmr
bdms|bdms
bdmt|bdmt
bdna|bdna
bdnb|bdnb
bdnc|bdnc
bdnd|bdnd
bdne|bdne
bdnf|bdnf
bdng|bdng
bdnh|bdnh
bdni|bdni
bdnj|bdnj
bdnk|bdnk
bdnl|bdnl
bdnm|bdnm
bdnn|bdnn
bdno|bdno
bdnp|bdnp
bdnq|bdnq
bdnr|bdnr
bdns|bdns
bdnt|bdnt
bdoa|bdoa
bdob|bdob
bdoc|bdoc
bdod|bdod
bdoe|bdoe
bdof|bdof
bdog|bdog
bdoh|bdoh
bdoi|bdoi
bdoj|bdoj
bdok|bdok
bdol|bdol
bdom|bdom
bdon|bdon
bdoo|bdoo
bdop|bdop
bdoq|bdoq
bdor|bdor
bdos|bdos
bdot|bdot
bdpa|bdpa
bdpb|bdpb
bdpc|bdpc
bdpd|bdpd
bdpe|bdpe
bdpf|bdpf
bdpg|bdpg
bdph|bdph
bdpi|bdpi
bdpj|bdpj
bdpk|bdpk
bdpl|bdpl
bdpm|bdpm
bdpn|bdpn
bdpo|bdpo
bdpp|bdpp
bdpq|bdpq
bdpr|bdpr
bdps|bdps
bdpt|bdpt
bdqa|bdqa
bdqb|bdqb
bdqc|bdqc
bdqd|bdqd
bdqe|bdqe
bdqf|bdqf
bdqg|bdqg
bdqh|bdqh
bdqi|bdqi
bdqj|bdqj
bdqk|bdqk
bdql|bdql
bdqm|bdqm
bdqn|bdqn
bdqo|bdqo
bdqp|bdqp
bdqq|bdqq
bdqr|bdqr
bdqs|bdqs
bdqt|bdqt
bdra|bdra
bdrb|bdrb
bdrc|bdrc
bdrd|bdrd
bdre|bdre
bdrf|bdrf
bdrg|bdrg
bdrh|bdrh
bdri|bdri
bdrj|bdrj
bdrk|bdrk
bdrl|bdrl
bdrm|bdrm
bdrn|bdrn
bdro|bdro
bdrp|bdrp
bdrq|bdrq
bdrr|bdrr
bdrs|bdrs
bdrt|bdrt
bdsa|bdsa
bdsb|bdsb
bdsc|bdsc
bdsd|bdsd
bdse|bdse
bdsf|bdsf
bdsg|bdsg
bdsh|bdsh
bdsi|bdsi
bdsj|bdsj
bdsk|bdsk
bdsl|bdsl
bdsm|bdsm
bdsn|bdsn
bdso|bdso
bdsp|bdsp
bdsq|bdsq
bdsr|bdsr
bdss|bdss
bdst|bdst
bdta|bdta
bdtb|bdtb
bdtc|bdtc
bdtd|bdtd
bdte|bdte
bdtf|bdtf
bdtg|bdtg
bdth|bdth
bdti|bdti
bdtj|bdtj
bdtk|bdtk
bdtl|bdtl
bdtm|bdtm
bdtn|bdtn
bdto|bdto
bdtp|bdtp
bdtq|bdtq
bdtr|bdtr
bdts|bdts
bdtt|bdtt
beaa|beaa
beab|beab
beac|beac
bead|bead
beae|beae
beaf|beaf
beag|beag
beah|beah
beai|beai
beaj|beaj
beak|beak
beal|beal
beam|beam
bean|bean
beao|beao
beap|beap
beaq|beaq
bear|bear
beas|beas
beat|beat
beba|beba
bebb|bebb
bebc|bebc
bebd|bebd
bebe|bebe
bebf|bebf
bebg|bebg
bebh|bebh
bebi|bebi
bebj|bebj
bebk|bebk
bebl|bebl
bebm|bebm
bebn|bebn
bebo|bebo
bebp|bebp
bebq|bebq
bebr|bebr
bebs|bebs
bebt|bebt
beca|beca
becb|becb
becc|becc
becd|becd
bece|bece
becf|becf
becg|becg
bech|bech
beci|beci
becj|becj
beck|beck
becl|becl
becm|becm
becn|becn
beco|beco
becp|becp
becq|becq
becr|becr
becs|becs
bect|bect
beda|beda
bedb|bedb
bedc|bedc
bedd|bedd
bede|bede
bedf|bedf
bedg|bedg
bedh|bedh
bedi|bedi
bedj|bedj
bedk|bedk
bedl|bedl
bedm|bedm
bedn|bedn
bedo|bedo
bedp|bedp
bedq|bedq
bedr|bedr
beds|beds
bedt|bedt
beea|beea
beeb|beeb
beec|beec
beed|beed
beee|beee
beef|beef
beeg|beeg
beeh|beeh
beei|beei
beej|beej
beek|beek
beel|beel
beem|beem
been|been
beeo|beeo
beep|beep
beeq|beeq
beer|beer
bees|bees
beet|beet
befa|befa
befb|befb
befc|befc
befd|befd
befe|befe
beff|beff
befg|befg
befh|befh
befi|befi
befj|befj
befk|befk
befl|befl
befm|befm
befn|befn
befo|befo
befp|befp
befq|befq
befr|befr
befs|befs
beft|beft
bega|bega
begb|begb
begc|begc
begd|begd
bege|bege
begf|begf
begg|begg
begh|begh
begi|begi
begj|begj
begk|begk
begl|begl
begm|begm
begn|begn
bego|bego
begp|begp
begq|begq
begr|begr
begs|begs
begt|begt
beha|beha
behb|behb
behc|behc
behd|behd
behe|behe
behf|behf
behg|behg
behh|behh
behi|behi
behj|behj
behk|behk
behl|behl
behm|behm
behn|behn
beho|beho
behp|behp
behq|behq
behr|behr
behs|behs
beht|beht
beia|beia
beib|beib
beic|beic
beid|beid
beie|beie
beif|beif
beig|beig
beih|beih
beii|beii
beij|beij
beik|beik
beil|beil
beim|beim
bein|bein
beio|beio
beip|beip
beiq|beiq
beir|beir
beis|beis
beit|beit
beja|beja
bejb|bejb
bejc|bejc
bejd|bejd
beje|beje
bejf|bejf
bejg|bejg
bejh|bejh
beji|beji
bejj|bejj
bejk|bejk
bejl|bejl
bejm|bejm
bejn|bejn
bejo|bejo
bejp|bejp
bejq|bejq
bejr|bejr
bejs|bejs
bejt|bejt
beka|beka
bekb|bekb
bekc|bekc
bekd|bekd
beke|beke
bekf|bekf
bekg|bekg
bekh|bekh
beki|beki
bekj|bekj
bekk|bekk
bekl|bekl
bekm|bekm
bekn|bekn
beko|beko
bekp|bekp
bekq|bekq
bekr|bekr
beks|beks
bekt|bekt
bela|bela
belb|belb
belc|belc
beld|beld
bele|bele
belf|belf
belg|belg
belh|belh
beli|beli
belj|belj
belk|belk
bell|bell
belm|belm
beln|beln
belo|belo
belp|belp
belq|belq
belr|belr
bels|bels
belt|belt
bema|bema
bemb|bemb
bemc|bemc
bemd|bemd
beme|beme
bemf|bemf
bemg|bemg
bemh|bemh
bemi|bemi
bemj|bemj
bemk|bemk
beml|beml
bemm|bemm
bemn|bemn
bemo|bemo
bemp|bemp
bemq|bemq
bemr|bemr
bems|bems
bemt|bemt
bena|bena
benb|benb
benc|benc
bend|bend
bene|bene
benf|benf
beng|beng
benh|benh
beni|beni
benj|benj
benk|benk
benl|benl
benm|benm
benn|benn
beno|beno
benp|benp
benq|benq
benr|benr
bens|bens
bent|bent
beoa|beoa
beob|beob
beoc|beoc
beod|beod
beoe|beoe
beof|beof
beog|beog
beoh|beoh
beoi|beoi
beoj|beoj
beok|beok
beol|beol
beom|beom
beon|beon
beoo|beoo
beop|beop
beoq|beoq
beor|beor
beos|beos
beot|beot
bepa|bepa
bepb|bepb
bepc|bepc
bepd|bepd
bepe|bepe
bepf|bepf
bepg|bepg
beph|beph
bepi|bepi
bepj|bepj
bepk|bepk
bepl|bepl
bepm|bepm
bepn|bepn
bepo|bepo
bepp|bepp
bepq|bepq
bepr|bepr
beps|beps
bept|bept
beqa|beqa
beqb|beqb
beqc|beqc
beqd|beqd
beqe|beqe
beqf|beqf
beqg|beqg
beqh|beqh
beqi|beqi
beqj|beqj
beqk|beqk
beql|beql
beqm|beqm
beqn|beqn
beqo|beqo
beqp|beqp
beqq|beqq
beqr|beqr
beqs|beqs
beqt|beqt
bera|bera
berb|berb
berc|berc
berd|berd
bere|bere
berf|berf
berg|berg
berh|berh
beri|beri
berj|berj
berk|berk
berl|berl
berm|berm
bern|bern
bero|bero
berp|berp
berq|berq
berr|berr
bers|bers
bert|bert
besa|besa
besb|besb
besc|besc
besd|besd
bese|bese
besf|besf
besg|besg
besh|besh
besi|besi
besj|besj
besk|besk
besl|besl
besm|besm
besn|besn
beso|beso
besp|besp
besq|besq
besr|besr
bess|bess
best|best
beta|beta
betb|betb
betc|betc
betd|betd
bete|bete
betf|betf
betg|betg
beth|beth
beti|beti
betj|betj
betk|betk
betl|betl
betm|betm
betn|betn
beto|beto
betp|betp
betq|betq
betr|betr
bets|bets
bett|bett
betu|betu
qwer|sss
qqqqq|asd
zzz|zzz
vvv|vvv
rrrrr|rrrrr
